border_size=1
usage=map

Dd          , Dd          , Dd          , Dd          , Dd          , Dd          , Dd          , Dd          , Dd          , Dd          , Dd          , Dd          , Dd          , Dd          , Dd          , Dd          , Dd          , Dd          , Dd          , Dd          , Dd          , Dd          , Dd          , Dd          , Dd          , Dd          , Dd          , Dd          
Dd          , Dd          , Dd          , Dd          , Dd          , Dd          , Dd^Esd      , Dd          , Dd          , Dd          , Dd          , Dd          , Dd^Vdt      , Dd          , Dd^Vdt      , Dd          , Dd          , Dd          , Dd          , Dd          , Dd          , Dd          , Dd          , Dd          , Dd          , Dd          , Dd^Yyyy     , Dd          
Dd          , Dd          , Dd          , Dd          , Dd          , Dd          , Dd          , Dd          , Dd          , Dd          , Dd          , Dd          , Ce          , Ce          , Ce          , Dd^Vdt      , Dd          , Dd          , Dd          , Dd          , Dd          , Dd          , Dd          , Dd          , Dd          , Dd          , Dd          , Dd          
Dd          , Dd          , Dd          , Dd          , Dd          , Dd          , Dd          , Dd          , Dd          , Dd          , Dd          , Dd^Vdt      , Ce          , Ke          , Ce          , Dd          , Dd^Vdt      , Dd          , Dd          , Dd          , Dd          , Dd          , Dd          , Dd          , Dd          , Dd          , Dd          , Dd          
Dd          , Dd          , Dd          , Dd          , Dd          , Dd          , Dd          , Dd          , Dd          , Dd          , Dd^Vdt      , Dd          , Dd          , Ce          , Dd          , Dd          , Dd          , Dd          , Dd          , Dd          , Dd          , Dd          , Dd          , Dd          , Dd          , Dd          , Dd          , Dd          
Dd          , Dd          , Dd          , Dd^Esd      , Dd          , Dd          , Dd          , Dd          , Dd          , Dd          , Dd          , Dd          , Dd          , Dd          , Dd          , Dd^Vdt      , Dd          , Dd          , Dd          , Dd          , Dd          , Dd^Esd      , Dd          , Dd          , Dd          , Dd          , Dd          , Dd          
Hd          , Hd          , Hd          , Dd          , Dd          , Dd          , Dd          , Dd          , Dd          , Dd          , Dd          , Dd          , Dd          , Dd          , Dd          , Dd          , Dd          , Dd          , Dd          , Dd          , Dd          , Dd          , Dd          , Dd          , Dd          , Dd          , Dd          , Dd          
Dd          , Md          , Md          , Hd          , Hd          , Dd          , Dd          , Dd          , Dd          , Dd          , Dd          , Dd          , Dd          , Dd          , Dd          , Dd          , Dd          , Dd          , Dd          , Dd          , Dd          , Dd          , Dd          , Dd          , Dd          , Dd          , Dd^Esd      , Dd          
Dd          , Dd          , Dd          , Md          , Md          , Hd          , Hd          , Hd          , Hd          , Dd          , Hd          , Dd          , Dd          , Dd          , Dd          , Dd          , Dd          , Dd          , Dd          , Dd          , Dd          , Dd          , Dd          , Dd          , Dd          , Dd          , Dd          , Dd          
Dd          , Dd          , Dd          , Dd          , Dd          , Md          , Md          , Dd          , Dd          , Dd          , Dd          , Dd          , Dd          , Dd          , Dd          , Dd          , Dd          , Dd          , Dd          , Dd          , Dd          , Dd          , Dd          , Dd          , Dd          , Dd          , Dd          , Dd          
Dd          , Dd          , Hd          , Dd          , Dd          , Dd          , Dd          , Dd          , Dd          , Dd          , Dd          , Dd          , Dd          , Dd          , Dd          , 1 Dd        , Dd          , Dd          , Dd          , Dd          , Dd          , Dd          , Dd^Esd      , Dd          , Dd          , Dd          , Dd          , Dd          
Dd          , Dd          , Hd          , Dd          , Dd          , Dd          , Dd          , Dd          , Dd          , Dd          , Dd          , Dd          , Dd          , Dd          , Dd          , Dd          , Dd          , Dd          , Dd          , Dd^Do       , Dd          , Dd          , Dd          , Dd          , Dd          , Dd          , Dd          , Dd          
Dd          , Dd          , Md          , Hd          , Hd          , Dd          , Dd          , Dd          , Dd          , Dd          , Dd          , Dd          , Dd          , Dd          , Dd          , Dd          , Dd          , Dd          , Dd          , Dd          , Hd          , Dd          , Dd          , Dd          , Dd          , Dd          , Dd          , Dd          
Dd          , Dd          , Md          , Hd          , Hd          , Dd          , Dd          , Dd          , Dd          , Dd^Esd      , Dd          , Dd          , Dd          , Dd          , Dd          , Dd          , Dd          , Dd          , Dd          , Dd          , Dd          , Hd          , Dd          , Dd          , Dd          , Dd          , Dd          , Dd          
Dd^Do       , Dd          , Md          , Md          , Hd          , Hd          , Dd          , Dd          , Dd          , Dd          , Dd          , Dd          , Dd          , Dd          , Dd          , Dd          , Dd          , Dd          , Dd          , Dd          , Dd          , Hd          , Hd          , Hd          , Dd          , Dd          , Dd          , Dd          
Dd          , Dd          , Dd          , Md          , Md          , Hd          , Hd          , Dd          , Dd^Do       , Dd^Do       , Dd          , Dd          , Dd          , Dd          , Dd          , Dd          , Dd          , Dd          , Dd          , Dd          , Dd          , Dd          , Hd          , Hd          , Hd          , Dd          , Dd          , Dd          
Dd          , Dd          , Dd          , Dd          , Md          , Md          , Md          , Hd          , Hd          , Dd          , Hd          , Dd          , Dd          , Dd          , Dd          , Dd          , Dd          , Dd          , Dd          , Dd          , Dd          , Dd          , Dd          , Hd          , Hd          , Hd          , Hd          , Dd          
Dd          , Dd          , Dd          , Dd          , Dd          , Hd          , Hd          , Hd          , Hd          , Hd          , Hd          , Hd          , Hd          , Hd          , Dd          , Dd          , Dd          , Dd          , Dd          , Dd          , Dd          , Dd          , Dd          , Dd          , Dd          , Hd          , Dd          , Dd          
Dd          , Dd          , Dd          , Dd^Esd      , Dd          , Dd          , Dd          , Md          , Dd          , Hd          , Dd          , Hd          , Dd          , Dd          , Dd          , Dd          , Dd          , Dd          , Dd          , Dd          , Dd          , Dd          , Dd          , Hd          , Dd          , Dd          , Dd          , Dd          
Hd          , Dd          , Dd          , Dd          , Dd          , Dd          , Dd          , Dd          , Dd          , Dd          , Dd          , Dd          , Dd          , Dd          , Dd          , Dd          , Dd          , Dd          , Dd          , Dd          , Dd          , Dd^Esd      , Dd          , Md          , Hd          , Dd          , Dd          , Dd          
Hd          , Hd          , Hd          , Dd          , Dd          , Dd          , Dd          , Dd          , Dd          , Dd          , Dd^Esd      , Dd          , Dd          , Dd          , Dd          , Dd          , Dd          , Dd          , Dd          , Dd          , Dd          , Dd          , Dd          , Md          , Md          , Hd          , Hd          , Dd          
Md          , Hd          , Hd          , Dd          , Dd          , Dd          , Dd          , Dd          , Dd          , Dd          , Dd          , Dd          , Dd          , Dd          , Dd          , Dd          , Dd          , Dd          , Dd          , Dd^Do       , Dd          , Dd          , Dd          , Dd          , Dd          , Md          , Md          , Hd          
Md          , Hd          , Hd          , Hd          , Hd          , Dd          , Dd          , Dd          , Dd          , Dd          , Dd          , Dd          , Dd          , Dd          , Dd          , Dd          , Dd^Esd      , Dd          , Dd          , Dd          , Dd          , Dd          , Dd          , Dd          , Dd          , Dd          , Dd          , Md          
Dd          , Md          , Md          , Hd          , Hd          , Hd          , Hd          , Dd          , Dd^Do       , Dd          , Dd          , Dd          , Dd          , Dd          , Dd          , Dd          , Dd          , Dd          , Dd          , Dd          , Dd          , Dd          , Hd          , Dd          , Dd          , Dd          , Dd          , Dd          
Dd          , Dd^Do       , Dd          , Md          , Md          , Hd          , Md          , Hd          , Hd          , Hd          , Hd          , Dd          , Hd          , Dd          , Dd          , Dd          , Dd          , Dd          , Dd          , Dd          , Dd          , Dd          , Dd          , Hd          , Hd          , Dd          , Dd          , Dd          
Dd          , Dd          , Dd          , Dd          , Dd          , Md          , Md          , Md          , Md          , Hd          , Md          , Hd          , Dd          , Dd          , Dd          , Dd          , Dd          , Dd          , Dd          , Dd          , Dd          , Dd          , Dd          , Dd          , Dd          , Dd          , Dd^Esd      , Dd          
Dd          , Dd          , Dd^Fjy      , Dd          , Dd          , Dd          , Dd          , Dd          , Dd          , Dd          , Dd          , Dd          , Dd          , Dd          , Dd^Fjy      , Dd          , Dd          , Dd          , Dd          , Dd          , Dd          , Dd          , Dd          , Gs          , Gs          , Dd          , Gs^Fjy      , Dd^Fjy      
Gs^Fjy      , Dd          , Dd^Fjy      , Dd          , Dd          , Dd^Fjy      , Dd^Fjy      , Dd          , Dd          , Dd^Esd      , Dd          , Dd          , Dd^Fjy      , Dd^Fjy      , Gs          , Gs          , Gs          , Gs          , Ss          , Dd          , Dd^Fjy      , Dd          , Dd          , Dd          , Dd^Fjy      , Gs^Fjy      , Gs^Fjy      , Gs^Fjy      
Gs^Fjy      , Gs^Fjy      , Dd^Fjy      , Dd^Fjy      , Dd^Fjy      , Dd^Fjy      , Dd^Fjy      , Gs^Fjy      , Gs^Fjy      , Dd          , Gs^Fjy      , Dd^Fjy      , Dd^Fjy      , Gs          , Gs          , Ss          , Gs^Fjy      , Ss          , Gs          , Ss^Fjy      , Gs^Fjy      , Dd^Fjy      , Gs          , Dd^Fjy      , Dd          , Dd^Fjy      , Dd^Fjy      , Gs^Fjy      
Gs^Fjy      , Gs^Fjy      , Gs^Fjy      , Dd^Fjy      , Gs^Fjy      , Gs^Fjy      , Ss          , Gs^Fjy      , Ss^Fjy      , Gs^Fjy      , Ss^Fjy      , Ss^Fjy      , Gs          , Gs          , Ss          , Ss^Fjy      , Ss^Fjy      , Gs^Fjy      , Gs^Fjy      , Ss^Fjy      , Gs^Fjy      , Gs^Fjy      , Gs^Fjy      , Gs          , Gs          , Gs          , Gs^Fjy      , Gs^Fjy      
Ss^Fjy      , Gs          , Ss^Fjy      , Ss^Fjy      , Ss^Fjy      , Gs^Fjy      , Ss          , Ss          , Gs          , Ss          , Ss          , Ss^Fjy      , Gs          , Gs          , Gs          , Gs          , Gs          , Ss^Fjy      , Ss^Fjy      , Gs^Fjy      , Gs          , Ss^Fjy      , Gs^Fjy      , Gs^Fjy      , Ss^Fjy      , Gs^Fjy      , Gs^Fjy      , Ss^Fjy      
Ss^Fjy      , Ss^Fjy      , Ss          , Ss^Fjy      , Gs          , Ss          , Ss          , Ss          , Gs^Fjy      , Gs          , Gs          , Gs          , Gs          , Gs          , Gs          , Gs          , Gs^Fjy      , Gs^Fjy      , Ss^Fjy      , Ss^Fjy      , Ss^Fjy      , Gs^Fjy      , Gs^Fjy      , Ss^Fjy      , Ss          , Ss          , Ss          , Gs          
Gs^Fjy      , Ss^Fjy      , Ss^Fjy      , Ss          , Ss          , Ss          , Ss^Fjy      , Ss^Fjy      , Ss^Fjy      , Gs          , Gs          , Gs          , Gs          , Gs          , Gs          , Gs          , Ss          , Ss          , Gs^Fjy      , Ss^Fjy      , Ss^Fjy      , Ss^Fjy      , Ss^Fjy      , Ss^Fjy      , Gs          , Ss          , Ss^Fjy      , Ss^Fjy      
Ss^Fjy      , Gs^Fjy      , Gs^Fjy      , Gs          , Gs^Fjy      , Gs^Fjy      , Gs^Fjy      , Ss^Fjy      , Ss^Fjy      , Ss          , Ss          , Gs          , Gs          , 2 Gs        , Gs          , Gs          , Ss          , Gs          , Ss          , Gs          , Ss^Fjy      , Ss^Fjy      , Ss          , Ss^Fjy      , Ss          , Gs^Fjy      , Ss^Fjy      , Ss^Fjy      
Ss^Fjy      , Ss^Fjy      , Gs^Fjy      , Ss^Fjy      , Ss^Fjy      , Gs^Fjy      , Ss^Fjy      , Gs^Fjy      , Ss^Fjy      , Gs^Fjy      , Gs^Fjy      , Ss          , Ss          , Gs          , Ss^Fjy      , Gs^Fjy      , Ss^Fjy      , Ss^Fjy      , Ss^Fjy      , Ss          , Ss          , Ss          , Ss          , Ss          , Ss^Fjy      , Ss^Fjy      , Ss^Fjy      , Ss^Fjy      
