border_size=1
usage=map

Ss^Xo       , Ss          , Ss          , Ss          , Ss          , Ss          , Ss          , Ss          , Ss          , Ss          , Ss          , Ss          , Ss          , Ss          , Gg          , Ss          , Ss          , Ss          , Ss          , Ss          , Gg          , Gg          , Gg          , Gg          , Gg          , Gg          , Gg          , Gg          , Gg          , Gg          , Gg          , Gg          , Gg          , Gg          , Gg          , Gg          , Gg          , Gg          , Gg
Ss^Xo       , Ss          , Ss^Xo       , Ss          , Ss          , Ss          , Ss          , Ss          , Ss          , Ss          , Ss          , Ss          , Ss^Xo       , Gg          , Gs^Xo       , Gg          , Gg^Xo       , Ss          , Ss          , Ss          , Ss          , Gg          , Gg          , Gg          , Gg          , Gg          , Gg          , Gg          , Gg          , Gg          , Gg          , Gg          , Gg          , Gg          , Gg          , Gg          , Gg          , Gg          , Gg
Ss^Xo       , Ss          , Ss^Xo       , Ss^Xo       , Ss^Xo       , Ss^Xo       , Ss^Xo       , Ss^Xo       , Ss^Xo       , Ss^Xo       , Ss^Xo       , Ss^Xo       , Gs^Xo       , Gg^Xo       , Gg^Xo       , Gg^Xo       , Gg^Xo       , Gg^Xo       , Gs^Xo       , Ss          , Gg          , Gs          , Gg          , Gg          , Gg          , Gg          , Gs          , Gg          , Gg          , Gg          , Gg          , Gg          , Gg          , Gg          , Gg          , Gg          , Gg          , Gg          , Gg
Ss^Xo       , Ss          , Ss^Xo       , Ss^Xo       , Ss^Xo       , Ss^Xo       , Ss^Xo       , Ss^Xo       , Ss^Xo       , Ss^Xo       , Ss^Xo       , Gg^Xo       , Gs          , Ss^Xo       , Gs^Xo       , Gg^Xo       , Gg          , Gg          , Gg          , Gs          , Re^Vct      , Dd^Vdt      , 4 Ss        , Gs          , Gg          , Gg          , Gs          , Gg          , Gg          , Gg          , Gg          , Gg          , Gg          , Gg          , Gg          , Gg          , Gg          , Gg          , Ss
Ss^Xo       , Ss          , Ss^Xo       , Ss^Xo       , Ss^Xo       , Ss          , Ss^Xo       , Ss^Xo       , Ss^Xo       , Ss^Xo       , Gs          , Gs          , Ss^Xo       , Ss^Xo       , Ss          , Gg          , Gg^Xo       , Gg          , Gg          , Ss          , Ss          , Ss          , Ss          , 1 Ss        , Ss          , Gs          , Ss          , Gs          , Gg          , Gg          , Gg          , Gs          , Ss          , Gs          , Ss^Xo       , Gg          , Ss          , Ss          , Ss
Ss^Xo       , Ss          , Ss^Xo       , Ss^Xo       , Ss^Xo       , Ss^Xo       , Ss^Xo       , Ss^Xo       , Ss^Xo       , Ss^Xo       , Ss^Xo       , Ss^Xo       , Ss          , Ss^Xo       , Ss^Xo       , Gs^Xo       , Ss^Xo       , Ss^Xo       , Gs^Xo       , Gg          , Gs^Xo       , Ss          , Ss          , Ss          , Ce          , Ss          , Ss          , Ss          , Dd^Vdt      , Re^Vct      , Ss          , Ss^Xo       , Ss^Xo       , Ss          , Gg^Xo       , Ss^Xo       , Ss^Xo       , Ss^Xo       , Ss^Xo
Ss^Xo       , Ss          , Ss^Xo       , Ss^Xo       , Rd^Xo       , Ss^Xo       , Rd^Xo       , Rd^Xo       , Rd^Xo       , Ss^Xo       , Ss^Xo       , Ss^Xo       , Ss^Xo       , Ss^Xo       , Ss^Xo       , Ss^Xo       , Ss^Xo       , Ss^Xo       , Ss^Xo       , Gs^Xo       , Ss^Xo       , Ss^Xo       , Ss          , Ss          , Ss          , Ce          , Ce          , Ke          , Ce          , Ss          , Ss^Xo       , Ss^Xo       , Ss^Xo       , Gg^Xo       , Ss^Xo       , Ss^Xo       , Ss^Xo       , Ss^Xo       , Ss^Xo
Rd^Xo       , Rd^Xo       , Rd^Xo       , Rd^Xo       , Rd^Xo       , Rd^Xo       , Rd^Xo       , Rd^Xo       , Rd^Xo       , Ss^Xo       , Rd^Xo       , Ss^Xo       , Ss^Xo       , Ss^Xo       , Ss^Xo       , Ss^Xo       , Ss^Xo       , Ss^Xo       , Ss^Xo       , Ss^Xo       , Ss^Xo       , Ss^Xo       , Ss          , Ss          , Ss          , Ss          , Ss          , Ce          , Ss^Xo       , Ss^Xo       , Ss^Xo       , Ss^Xo       , Ss^Xo       , Ss^Xo       , Ss^Xo       , Ss^Xo       , Ss^Xo       , Ss^Xo       , Ss^Xo
Rd^Xo       , Rd^Xo       , Rd^Xo       , Rd^Xo       , Rd^Xo       , Rd^Xo       , Rd^Xo       , Rd^Xo       , Rd^Xo       , Rd^Xo       , Rd^Xo       , Rd^Xo       , Rd^Xo       , Ss^Xo       , Rd^Xo       , Ss^Xo       , Ss^Xo       , Ss^Xo       , Ss          , Ss^Xo       , Ss          , Ss          , Ss          , Ss          , Ss          , Ss^Xo       , Ss^Xo       , Ss^Xo       , Ss^Xo       , Ss^Xo       , Ss^Xo       , Ss^Xo       , Ss^Xo       , Ss^Xo       , Ss^Xo       , Ss^Xo       , Ss^Xo       , Ss^Xo       , Ss^Xo
Rd^Xo       , Rd          , Rd^Xo       , Rd^Xo       , Rd^Xo       , Rd^Xo       , Rd^Xo       , Rd^Xo       , Rd^Xo       , Rd^Xo       , Rd^Xo       , Rd^Xo       , Rd^Xo       , Rd^Xo       , Rd^Xo       , Ss^Xo       , Rd          , Ss          , Rd          , Rd          , Rd          , Ss          , Ss^Xo       , Ss^Xo       , Ss^Xo       , Ss^Xo       , Ss^Xo       , Ss^Xo       , Ss^Xo       , Ss^Xo       , Ss^Xo       , Ss^Xo       , Ss^Xo       , Ss^Xo       , Ss^Xo       , Ss^Xo       , Ss^Xo       , Ss^Xo       , Ss^Xo
Rd^Xo       , Rd          , Rd^Xo       , Rd^Xo       , Rd^Xo       , Rd^Xo       , Rd^Xo       , Rd^Xo       , Rd^Xo       , Rd^Xo       , Rd^Xo       , Rd^Xo       , Rd^Xo       , Rd^Xo       , Rd^Xo       , Rd          , Rd          , Rd          , Rd          , Rd          , Rd          , Rd          , Rd^Xo       , Ss^Xo       , Ss^Xo       , Ss^Xo       , Ss^Xo       , Ss^Xo       , Ss^Xo       , Ss^Xo       , Ss^Xo       , Ss^Xo       , Ss^Xo       , Ss^Xo       , Ss^Xo       , Ss^Xo       , Ss^Xo       , Ss^Xo       , Ss^Xo
Rd^Xo       , Rd          , Rd^Xo       , Rd^Xo       , Rd^Xo       , Rd^Xo       , Rd^Xo       , Rd^Xo       , Rd^Xo       , Wo          , Wo          , Rd^Xo       , Ww          , Rd^Xo       , Rd^Xo       , Rd^Xo       , Rd^Xo       , Rd^Xo       , Rd^Xo       , Rd          , Rd          , Rd          , Rd          , Rd^Xo       , Rd^Xo       , Rd^Xo       , Rd^Xo       , Rd^Xo       , Rd^Xo       , Rd^Xo       , Rd^Xo       , Rd^Xo       , Rd^Xo       , Rd^Xo       , Rd^Xo       , Rd^Xo       , Rd^Xo       , Rd^Xo       , Ss^Xo
Rd^Xo       , Rd          , Rd^Xo       , Rd^Xo       , Rd^Xo       , Rd^Xo       , Rd^Xo       , Rd^Xo       , Rd^Xo       , Rd^Xo       , Wo          , Wo          , Wo          , Ww          , Rd^Xo       , Rd^Xo       , Ss^Xo       , Rd^Xo       , Rd          , Rd          , Rd          , Rd          , Rd          , Rd^Xo       , Rd^Xo       , Rd^Xo       , Rd^Xo       , Rd^Xo       , Rd^Xo       , Rd^Xo       , Rd^Xo       , Rd^Xo       , Rd^Xo       , Rd^Xo       , Rd^Xo       , Rd^Xo       , Rd^Xo       , Rd^Xo       , Ss^Xo
Rd^Xo       , Rd          , Rd^Xo       , Rd^Xo       , Rd^Xo       , Rd^Xo       , Rd^Xo       , Rd^Xo       , Rd^Xo       , Rd^Xo       , Ww          , Wo          , Ww^Xo       , Rd^Xo       , Rd^Xo       , Ss^Xo       , Ss^Xo       , Rd^Xo       , Rd          , Rd          , Rd          , Rd          , Rd          , Rd^Xo       , Rd^Xo       , Rd^Xo       , Rd^Xo       , Rd^Xo       , Rd^Xo       , Rd^Xo       , Rd^Xo       , Rd^Xo       , Rd^Xo       , Rd^Xo       , Rd^Xo       , Rd^Xo       , Rd^Xo       , Rd^Xo       , Ss^Xo
Rd^Xo       , Rd          , Rd^Xo       , Rd^Xo       , Rd^Xo       , Rd^Xo       , Rd^Xo       , Rd^Xo       , Rd^Xo       , Rd^Xo       , Rd^Xo       , Rd^Xo       , Ww          , Dd^Xo       , Dd          , Dd^Xo       , Dd          , Dd^Xo       , Dd          , Rd          , Rd          , Rd          , Rd^Xo       , Rd^Xo       , Ss^Xo       , Rd^Xo       , Rd^Xo       , Rd^Xo       , Rd^Xo       , Rd^Xo       , Rd^Xo       , Rd^Xo       , Rd^Xo       , Rd^Xo       , Rd^Xo       , Rd^Xo       , Rd^Xo       , Rd^Xo       , Ss^Xo
Rd^Xo       , Rd          , Rd^Xo       , Rd^Xo       , Rd^Xo       , Rd^Xo       , Rd^Xo       , Rd^Xo       , Dd^Xo       , Dd^Xo       , Dd^Xo       , Dd^Xo       , Dd          , Ww          , Wwf         , Dd          , Ww          , Dd          , Dd          , Dd          , Dd          , Dd          , Dd          , Ss          , Ss^Xo       , Ss^Xo       , Rd^Xo       , Rd^Xo       , Rd^Xo       , Rd^Xo       , Rd^Xo       , Rd^Xo       , Rd^Xo       , Rd^Xo       , Rd^Xo       , Rd^Xo       , Ss^Xo       , Ss^Xo       , Ss^Xo
Rd^Xo       , Rd^Xo       , Rd^Xo       , Rd^Xo       , Rd^Xo       , Rd^Xo       , Rd^Xo       , Dd^Xo       , Dd^Xo       , Dd^Xo       , Dd          , Dd          , Dd          , Dd          , Dd          , Wwf         , Dd          , Ww          , Ww          , Dd          , Dd          , Dd          , Dd          , Dd          , Dd          , Ss^Xo       , Ss^Xo       , Ss^Xo       , Rd^Xo       , Rd^Xo       , Rd^Xo       , Rd^Xo       , Ss^Xo       , Rd^Xo       , Ss^Xo       , Ss^Xo       , Ss^Xo       , Ss^Xo       , Ss^Xo
Rd^Xo       , Rd^Xo       , Rd^Xo       , Rd^Xo       , Dd^Xo       , Rd^Xo       , Dd^Xo       , Dd^Xo       , Dd          , Dd          , Dd          , Dd          , Dd          , Dd          , Dd          , Dd          , Dd          , Dd          , Wwf         , Dd          , Dd          , Dd          , Dd          , Dd          , Dd          , Ss          , Ss          , Ss^Xo       , Ss^Xo       , Ss^Xo       , Ss^Xo       , Ss^Xo       , Ss^Xo       , Ss^Xo       , Ss^Xo       , Ss^Xo       , Ss^Xo       , Ss^Xo       , Ss^Xo
Rd^Xo       , Rd^Xo       , Dd^Xo       , Dd^Xo       , Dd^Xo       , Dd^Xo       , Dd          , Dd          , Dd          , Dd          , Dd          , Dd          , Dd          , Dd          , Dd          , Dd          , Dd          , 2 Dd        , Dd          , Wwf         , Dd          , Ss          , Ss^Xo       , Dd^Xo       , Dd          , Ss          , Ss          , Ss          , Ss          , Ss^Xo       , Ss          , Ss^Xo       , Ss^Xo       , Ss^Xo       , Ss^Xo       , Ss^Xo       , Ss^Xo       , Ss^Xo       , Ss^Xo
Dd^Xo       , Dd          , Dd^Xo       , Dd^Xo       , Re^Vct      , Dd          , Dd          , Dd^Do       , Dd          , Dd          , Dd          , Dd          , Dd          , Dd          , Dd          , Dd          , Dd          , Dd          , Dd          , Ww          , Ss          , Dd          , Ss^Xo       , Ss^Xo       , Ss^Xo       , Ss          , Ss          , Ss          , Ss          , Ss          , Ss          , Ss^Xo       , Ss^Xo       , Ss^Xo       , Ss^Xo       , Ss^Xo       , Ss^Xo       , Ss^Xo       , Ss^Xo
Dd          , Dd          , Dd^Vdt      , Dd          , Dd          , Dd          , Dd          , Dd          , Dd          , Dd          , Dd          , Dd          , Dd          , Dd          , Dd          , Dd          , Dd          , Dd          , Dd          , Ww          , Ss          , Ss          , Ss^Xo       , Ss^Xo       , Ss^Xo       , Ss^Xo       , Ss^Xo       , Ss          , Ss          , Ss          , Ss          , Ss          , Cud         , Ss^Xo       , Ss^Xo       , Ss^Xo       , Ss^Xo       , Ss^Xo       , Ss
Dd          , Dd          , Dd          , Dd          , Dd          , Dd          , Dd          , Dd          , Dd          , Dd          , Dd          , Dd          , Dd          , Dd          , Dd          , Dd          , Dd          , Dd          , Dd          , Wwf         , Ww          , Ss          , Ss          , Ss^Xo       , Ss^Xo       , Ss^Xo       , Ss          , Ss          , Ss          , Ss          , Ss          , Ss          , Cud         , Ss          , Cud         , Ss          , Cud         , Ss          , Ss
Dd          , Dd          , Dd^Vdt      , Dd^Vdt      , Dd          , Dd          , Dd          , Dd          , Dd          , Dd          , Dd          , Dd          , Dd          , Dd^Do       , Dd          , Dd          , Dd          , Dd          , Dd          , Dd          , Dd^Xo       , Ww          , Ww          , Ss          , Ss          , Ss          , Ss          , Ss          , Ss          , Ss          , Ss          , Cud         , Ss          , Cud         , Kud         , Cud         , Ss          , Cud         , Ss
Dd          , Dd          , Dd          , Dd          , Dd          , Dd          , Dd          , Dd          , Re^Vct      , Dd          , Dd          , Dd          , Dd^Xo       , Dd^Xo       , Dd^Xo       , Dd^Xo       , Dd^Xo       , Dd          , Dd^Xo       , Dd^Xo       , Ss^Xo       , Ss^Xo       , Ss^Xo       , Ww          , Ww          , Ww          , Ww          , Ss          , Ww          , Ss          , Ss          , Ss          , Ss          , Cud         , Cud         , Cud         , Ss          , Ss          , Ss
Dd          , Dd          , Ce          , Ce          , Ce          , Dd          , Dd          , Dd          , Dd          , Dd          , Dd^Xo       , Dd^Xo       , Dd^Xo       , Dd^Xo       , Dd^Xo       , Dd^Xo       , Dd^Xo       , Dd^Xo       , Dd^Xo       , Dd^Xo       , Ss^Xo       , Ss^Xo       , Ss^Xo       , Ss^Xo       , Ss          , Ww          , Ss^Vm       , Ww          , Ss          , Ww          , Ww^Bw/      , Ss          , Ss          , Ss          , Cud         , Ss          , Ss          , Ss          , Ss
Dd          , Dd          , Ce          , 3 Ke        , Ce          , Ce          , Dd          , Dd          , Dd          , Dd          , Dd^Xo       , Dd^Xo       , Dd^Xo       , Dd^Xo       , Dd^Xo       , Dd^Xo       , Dd^Xo       , Dd^Xo       , Ss^Xo       , Ss^Xo       , Ss^Xo       , Ss^Xo       , Ss^Xo       , Ss^Xo       , Ss^Xo       , Ss          , Ss          , Ss^Xo       , Ss^Xo       , Ss          , Ww          , Ss^Vhs      , Ss          , Ss          , Ss          , Ss          , Ss          , Ss^Vm       , Ss
Dd          , Dd          , Dd          , Ce          , Dd          , Dd          , Dd^Xo       , Dd^Xo       , Dd^Xo       , Dd          , Dd^Xo       , Dd^Xo       , Dd^Xo       , Dd^Xo       , Dd^Xo       , Dd^Xo       , Ss^Xo       , Ss^Xo       , Ss^Xo       , Ss^Xo       , Ss^Xo       , Ss^Xo       , Ss^Xo       , Ss^Xo       , Ss^Xo       , Ss          , Ss          , Ss^Xo       , Ss^Xo       , Ss^Xo       , Ss^Xo       , Ww          , Ww          , Ss          , Ss          , Ss          , Ww^Bw/      , Ss          , Ss
Dd          , Dd          , Dd          , Dd          , Dd^Xo       , Dd^Xo       , Dd^Xo       , Dd^Xo       , Dd^Xo       , Dd^Xo       , Dd^Xo       , Dd^Xo       , Dd^Xo       , Dd^Xo       , Ss^Xo       , Ss^Xo       , Ss^Xo       , Ss^Xo       , Ss^Xo       , Ss^Xo       , Ss^Xo       , Ss^Xo       , Ss^Xo       , Ss^Xo       , Ss          , Ss^Vhs      , Ss^Xo       , Ss^Xo       , Ss^Xo       , Ss^Xo       , Ss^Xo       , Ss^Xo       , Ss^Xo       , Ww          , Ww^Xo       , Ww^Xo       , Ss^Xo       , Ww          , Ww
Dd          , Dd          , Dd^Xo       , Dd^Xo       , Dd^Xo       , Dd^Xo       , Dd^Xo       , Dd^Xo       , Dd^Xo       , Dd^Xo       , Dd^Xo       , Dd^Xo       , Dd^Xo       , Ss^Xo       , Ss^Xo       , Ss^Xo       , Ss^Xo       , Ss^Xo       , Ss^Xo       , Ss^Xo       , Ss^Xo       , Ss^Xo       , Ss          , Ss^Vhs      , Ss          , Ss^Xo       , Ss^Xo       , Ss^Xo       , Ss^Xo       , Ss^Xo       , Ss^Xo       , Ss^Xo       , Ss^Xo       , Ww^Xo       , Ww^Xo       , Ss^Xo       , Ss^Xo       , Ss^Xo       , Ss
Dd          , Dd          , Dd^Xo       , Dd^Xo       , Dd^Xo       , Dd^Xo       , Dd^Xo       , Dd^Xo       , Dd^Xo       , Dd^Xo       , Dd^Xo       , Dd^Xo       , Ss^Xo       , Ss^Xo       , Ss^Xo       , Ss^Xo       , Ss^Xo       , Ss^Xo       , Ss^Xo       , Ss^Xo       , Ss^Xo       , Ss^Xo       , Ss          , Ss          , Ss^Vhs      , Ss^Xo       , Ss^Xo       , Ss^Xo       , Ss^Xo       , Ss^Xo       , Ss^Xo       , Ss^Xo       , Ss^Xo       , Ss^Xo       , Ww^Xo       , Ss^Xo       , Ww^Xo       , Ss^Xo       , Ss
Dd          , Dd          , Dd^Xo       , Dd^Xo       , Dd^Xo       , Dd^Xo       , Dd^Xo       , Dd^Xo       , Dd^Xo       , Dd^Xo       , Dd^Xo       , Dd^Xo       , Ss^Xo       , Ss^Xo       , Ss^Xo       , Ss^Xo       , Ss^Xo       , Ss^Xo       , Ss^Xo       , Ss^Xo       , Ss^Xo       , Ss^Xo       , Ss          , Ss          , Ss          , Ss^Xo       , Ss^Xo       , Ss^Xo       , Ss^Xo       , Ss^Xo       , Ss^Xo       , Ss^Xo       , Ss^Xo       , Ss^Xo       , Ss^Xo       , Ww^Xo       , Ss          , Ww          , Ww
