border_size=1
usage=map

Xv          , Xv          , Xv          , Xv          , Xv          , Xv          , Xv^Xo       , Xv          , Xv^Xo       , Xv          , Xv          , Xv          , Xv          , Xv          , Xv          , Xv          , Xv          , Xv          , Xv          , Xv          , Xv          , Xv          , Xv          , Xv          , Xv          , Xv          , Xv          , Xv          , Xv          , Xv          , Xv          , Xv          , Xv          , Xv          , Xv          , Xv          , Xv          , Xv          , Xv          , Xv          
Xv          , Xv          , Ss^Xo       , Xv^Xo       , Ss^Xo       , Xv^Xo       , Ss^Xo       , Xv^Xo       , Ss^Xo       , Xv^Xo       , Ss^Xo       , Xv^Xo       , Ss^Xo       , Xv          , Gs^Xo       , Xv^Xo       , Gg^Xo       , Xv          , Ss          , Xv          , Ss          , Xv          , Gg          , Xv          , Gg          , Xv          , Gg          , Xv          , Gg          , Xv          , Gg          , Xv          , Gg          , Xv          , Gg          , Xv          , Gg          , Xv          , Gg          , Xv          
Xv          , Xv          , Ss^Xo       , Ss^Xo       , Ss^Xo       , Ss^Xo       , Ss^Xo       , Ss^Xo       , Ss^Xo       , Ss^Xo       , Ss^Xo       , Ss^Xo       , Gs^Xo       , Gg^Xo       , Gg^Xo       , Gg^Xo       , Gg^Xo       , Gg^Xo       , Gs^Xo       , Ss          , Gg          , Gs          , Gg          , Gg          , Gg          , Gg          , Gs          , Gg          , Gg          , Gg          , Gg          , Gg          , Gg          , Gg          , Gg          , Gg          , Gg          , Gg          , Gg          , Ss          
Xv          , Xv          , Ss^Xo       , Ss^Xo       , Ss^Xo       , Ss^Xo       , Ss^Xo       , Ss^Xo       , Ss^Xo       , Ss^Xo       , Ss^Xo       , Gg^Xo       , Gs          , Ss^Xo       , Gs^Xo       , Gg^Xo       , Gg          , Gg          , Gg          , Gs          , Re^Vct      , Dd^Vdt      , 4 Ss        , Gs          , Gg          , Gg          , Gs          , Gg          , Gg          , Gg          , Gg          , Gg          , Gg          , Gg          , Gg          , Gg          , Gg          , Gg          , Ss          , Ss          
Xv          , Xv          , Ss^Xo       , Ss^Xo       , Ss^Xo       , Ss          , Ss^Xo       , Ss^Xo       , Ss^Xo       , Ss^Xo       , Gs          , Gs          , Ss^Xo       , Ss^Xo       , Ss          , Gg          , Gg^Xo       , Gg          , Gg          , Ss          , Ss          , Ss          , Ss          , 1 Ss        , Ss          , Gs          , Ss          , Gs          , Gg          , Gg          , Gg          , Gs          , Ss          , Gs          , Ss^Xo       , Gg          , Ss          , Ss          , Ss          , Ss          
Xv          , Xv          , Ss^Xo       , Ss^Xo       , Ss^Xo       , Ss^Xo       , Ss^Xo       , Ss^Xo       , Ss^Xo       , Ss^Xo       , Ss^Xo       , Ss^Xo       , Ss          , Ss^Xo       , Ss^Xo       , Gs^Xo       , Ss^Xo       , Ss^Xo       , Gs^Xo       , Gg          , Gs^Xo       , Ss          , Ss          , Ss          , Ce          , Ss          , Ss          , Ss          , Dd^Vdt      , Re^Vct      , Ss          , Ss^Xo       , Ss^Xo       , Ss          , Gg^Xo       , Ss^Xo       , Ss^Xo       , Ss^Xo       , Ss^Xo       , Ss          
Xv          , Xv          , Ss^Xo       , Ss^Xo       , Rd^Xo       , Ss^Xo       , Rd^Xo       , Rd^Xo       , Rd^Xo       , Ss^Xo       , Ss^Xo       , Ss^Xo       , Ss^Xo       , Ss^Xo       , Ss^Xo       , Ss^Xo       , Ss^Xo       , Ss^Xo       , Ss^Xo       , Gs^Xo       , Ss^Xo       , Ss^Xo       , Ss          , Ss          , Ss          , Ce          , Ce          , Ke          , Ce          , Ss          , Ss^Xo       , Ss^Xo       , Ss^Xo       , Gg^Xo       , Ss^Xo       , Ss^Xo       , Ss^Xo       , Ss^Xo       , Ss^Xo       , Ss^Xo       
Xv          , Xv          , Rd^Xo       , Rd^Xo       , Rd^Xo       , Rd^Xo       , Rd^Xo       , Rd^Xo       , Rd^Xo       , Ss^Xo       , Rd^Xo       , Ss^Xo       , Ss^Xo       , Ss^Xo       , Ss^Xo       , Ss^Xo       , Ss^Xo       , Ss^Xo       , Ss^Xo       , Ss^Xo       , Ss^Xo       , Ss^Xo       , Ss          , Ss          , Ss          , Ss          , Ss          , Ce          , Ss^Xo       , Ss^Xo       , Ss^Xo       , Ss^Xo       , Ss^Xo       , Ss^Xo       , Ss^Xo       , Ss^Xo       , Ss^Xo       , Ss^Xo       , Ss^Xo       , Ss^Xo       
Xv          , Xv          , Rd^Xo       , Rd^Xo       , Rd^Xo       , Rd^Xo       , Rd^Xo       , Rd^Xo       , Rd^Xo       , Rd^Xo       , Rd^Xo       , Rd^Xo       , Rd^Xo       , Ss^Xo       , Rd^Xo       , Ss^Xo       , Ss^Xo       , Ss^Xo       , Ss          , Ss^Xo       , Ss          , Ss          , Ss          , Ss          , Ss          , Ss^Xo       , Ss^Xo       , Ss^Xo       , Ss^Xo       , Ss^Xo       , Ss^Xo       , Ss^Xo       , Ss^Xo       , Ss^Xo       , Ss^Xo       , Ss^Xo       , Ss^Xo       , Ss^Xo       , Ss^Xo       , Ss^Xo       
Xv          , Xv          , Rd^Xo       , Rd^Xo       , Rd^Xo       , Rd^Xo       , Rd^Xo       , Rd^Xo       , Rd^Xo       , Rd^Xo       , Rd^Xo       , Rd^Xo       , Rd^Xo       , Rd^Xo       , Rd^Xo       , Ss^Xo       , Rd          , Ss          , Rd          , Rd          , Rd          , Ss          , Ss^Xo       , Ss^Xo       , Ss^Xo       , Ss^Xo       , Ss^Xo       , Ss^Xo       , Ss^Xo       , Ss^Xo       , Ss^Xo       , Ss^Xo       , Ss^Xo       , Ss^Xo       , Ss^Xo       , Ss^Xo       , Ss^Xo       , Ss^Xo       , Ss^Xo       , Ss^Xo       
Xv          , Xv          , Rd^Xo       , Rd^Xo       , Rd^Xo       , Rd^Xo       , Rd^Xo       , Rd^Xo       , Rd^Xo       , Rd^Xo       , Rd^Xo       , Rd^Xo       , Rd^Xo       , Rd^Xo       , Rd^Xo       , Rd          , Rd          , Rd          , Rd          , Rd          , Rd          , Rd          , Rd^Xo       , Ss^Xo       , Ss^Xo       , Ss^Xo       , Ss^Xo       , Ss^Xo       , Ss^Xo       , Ss^Xo       , Ss^Xo       , Ss^Xo       , Ss^Xo       , Ss^Xo       , Ss^Xo       , Ss^Xo       , Ss^Xo       , Ss^Xo       , Ss^Xo       , Ss          
Xv          , Xv^Xo       , Rd^Xo       , Rd^Xo       , Rd^Xo       , Rd^Xo       , Rd^Xo       , Rd^Xo       , Rd^Xo       , Wo          , Wo          , Rd^Xo       , Ww          , Rd^Xo       , Rd^Xo       , Rd^Xo       , Rd^Xo       , Rd^Xo       , Rd^Xo       , Rd          , Rd          , Rd          , Rd          , Rd^Xo       , Rd^Xo       , Rd^Xo       , Rd^Xo       , Rd^Xo       , Rd^Xo       , Rd^Xo       , Rd^Xo       , Rd^Xo       , Rd^Xo       , Rd^Xo       , Rd^Xo       , Rd^Xo       , Rd^Xo       , Rd^Xo       , Ss^Xo       , Ss          
Xv          , Xv          , Rd^Xo       , Rd^Xo       , Rd^Xo       , Rd^Xo       , Rd^Xo       , Rd^Xo       , Rd^Xo       , Rd^Xo       , Wo          , Wo          , Wo          , Ww          , Rd^Xo       , Rd^Xo       , Ss^Xo       , Rd^Xo       , Rd          , Rd          , Rd          , Rd          , Rd          , Rd^Xo       , Rd^Xo       , Rd^Xo       , Rd^Xo       , Rd^Xo       , Rd^Xo       , Rd^Xo       , Rd^Xo       , Rd^Xo       , Rd^Xo       , Rd^Xo       , Rd^Xo       , Rd^Xo       , Rd^Xo       , Rd^Xo       , Ss^Xo       , Ss          
Xv          , Xv          , Rd^Xo       , Rd^Xo       , Rd^Xo       , Rd^Xo       , Rd^Xo       , Rd^Xo       , Rd^Xo       , Rd^Xo       , Ww          , Wo          , Ww^Xo       , Rd^Xo       , Rd^Xo       , Ss^Xo       , Ss^Xo       , Rd^Xo       , Rd          , Rd          , Rd          , Rd          , Rd          , Rd^Xo       , Rd^Xo       , Rd^Xo       , Rd^Xo       , Rd^Xo       , Rd^Xo       , Rd^Xo       , Rd^Xo       , Rd^Xo       , Rd^Xo       , Rd^Xo       , Rd^Xo       , Rd^Xo       , Rd^Xo       , Rd^Xo       , Ss^Xo       , Ss          
Xv          , Xv          , Rd^Xo       , Rd^Xo       , Rd^Xo       , Rd^Xo       , Rd^Xo       , Rd^Xo       , Rd^Xo       , Rd^Xo       , Rd^Xo       , Rd^Xo       , Ww          , Dd^Xo       , Dd          , Dd^Xo       , Dd          , Dd^Xo       , Dd          , Rd          , Rd          , Rd          , Rd^Xo       , Rd^Xo       , Ss^Xo       , Rd^Xo       , Rd^Xo       , Rd^Xo       , Rd^Xo       , Rd^Xo       , Rd^Xo       , Rd^Xo       , Rd^Xo       , Rd^Xo       , Rd^Xo       , Rd^Xo       , Rd^Xo       , Rd^Xo       , Ss^Xo       , Ss^Xo       
Xv          , Xv          , Rd^Xo       , Rd^Xo       , Rd^Xo       , Rd^Xo       , Rd^Xo       , Rd^Xo       , Dd^Xo       , Dd^Xo       , Dd^Xo       , Dd^Xo       , Dd          , Ww          , Wwf         , Dd          , Ww          , Dd          , Dd          , Dd          , Dd          , Dd          , Dd          , Ss          , Ss^Xo       , Ss^Xo       , Rd^Xo       , Rd^Xo       , Rd^Xo       , Rd^Xo       , Rd^Xo       , Rd^Xo       , Rd^Xo       , Rd^Xo       , Rd^Xo       , Rd^Xo       , Ss^Xo       , Ss^Xo       , Ss^Xo       , Ss^Xo       
Xv          , Xv          , Rd^Xo       , Rd^Xo       , Rd^Xo       , Rd^Xo       , Rd^Xo       , Dd^Xo       , Dd^Xo       , Dd^Xo       , Dd          , Dd          , Dd          , Dd          , Dd          , Wwf         , Dd          , Ww          , Ww          , Dd          , Dd          , Dd          , Dd          , Dd          , Dd          , Ss^Xo       , Ss^Xo       , Ss^Xo       , Rd^Xo       , Rd^Xo       , Rd^Xo       , Rd^Xo       , Ss^Xo       , Rd^Xo       , Ss^Xo       , Ss^Xo       , Ss^Xo       , Ss^Xo       , Ss^Xo       , Ss^Xo       
Xv          , Xv          , Rd^Xo       , Rd^Xo       , Dd^Xo       , Rd^Xo       , Dd^Xo       , Dd^Xo       , Dd          , Dd          , Dd          , Dd          , Dd          , Dd          , Dd          , Dd          , Dd          , Dd          , Wwf         , Dd          , Dd          , Dd          , Dd          , Dd          , Dd          , Ss          , Ss          , Ss^Xo       , Ss^Xo       , Ss^Xo       , Ss^Xo       , Ss^Xo       , Ss^Xo       , Ss^Xo       , Ss^Xo       , Ss^Xo       , Ss^Xo       , Ss^Xo       , Ss^Xo       , Ss^Xo       
Xv          , Xv          , Dd^Xo       , Dd^Xo       , Dd^Xo       , Dd^Xo       , Dd          , Dd          , Dd          , Dd          , Dd          , Dd          , Dd          , Dd          , Dd          , Dd          , Dd          , 2 Dd        , Dd          , Wwf         , Dd          , Ss          , Ss^Xo       , Dd^Xo       , Dd          , Ss          , Ss          , Ss          , Ss          , Ss^Xo       , Ss          , Ss^Xo       , Ss^Xo       , Ss^Xo       , Ss^Xo       , Ss^Xo       , Ss^Xo       , Ss^Xo       , Ss^Xo       , Ss^Xo       
Xv          , Xv          , Dd^Xo       , Dd^Xo       , Re^Vct      , Dd          , Dd          , Dd^Do       , Dd          , Dd          , Dd          , Dd          , Dd          , Dd          , Dd          , Dd          , Dd          , Dd          , Dd          , Ww          , Ss          , Dd          , Ss^Xo       , Ss^Xo       , Ss^Xo       , Ss          , Ss          , Ss          , Ss          , Ss          , Ss          , Ss^Xo       , Ss^Xo       , Ss^Xo       , Ss^Xo       , Ss^Xo       , Ss^Xo       , Ss^Xo       , Ss^Xo       , Ss^Xo       
Xv          , Xv          , Dd^Vdt      , Dd          , Dd          , Dd          , Dd          , Dd          , Dd          , Dd          , Dd          , Dd          , Dd          , Dd          , Dd          , Dd          , Dd          , Dd          , Dd          , Ww          , Ss          , Ss          , Ss^Xo       , Ss^Xo       , Ss^Xo       , Ss^Xo       , Ss^Xo       , Ss          , Ss          , Ss          , Ss          , Ss          , Cud         , Ss^Xo       , Ss^Xo       , Ss^Xo       , Ss^Xo       , Ss^Xo       , Ss          , Ss^Xo       
Xv          , Xv          , Dd          , Dd          , Dd          , Dd          , Dd          , Dd          , Dd          , Dd          , Dd          , Dd          , Dd          , Dd          , Dd          , Dd          , Dd          , Dd          , Dd          , Wwf         , Ww          , Ss          , Ss          , Ss^Xo       , Ss^Xo       , Ss^Xo       , Ss          , Ss          , Ss          , Ss          , Ss          , Ss          , Cud         , Ss          , Cud         , Ss          , Cud         , Ss          , Ss          , Ss          
Xv          , Xv          , Dd^Vdt      , Dd^Vdt      , Dd          , Dd          , Dd          , Dd          , Dd          , Dd          , Dd          , Dd          , Dd          , Dd^Do       , Dd          , Dd          , Dd          , Dd          , Dd          , Dd          , Dd^Xo       , Ww          , Ww          , Ss          , Ss          , Ss          , Ss          , Ss          , Ss          , Ss          , Ss          , Cud         , Ss          , Cud         , Kud         , Cud         , Ss          , Cud         , Ss          , Ss          
Xv          , Xv          , Dd          , Dd          , Dd          , Dd          , Dd          , Dd          , Re^Vct      , Dd          , Dd          , Dd          , Dd^Xo       , Dd^Xo       , Dd^Xo       , Dd^Xo       , Dd^Xo       , Dd          , Dd^Xo       , Dd^Xo       , Ss^Xo       , Ss^Xo       , Ss^Xo       , Ww          , Ww          , Ww          , Ww          , Ss          , Ww          , Ss          , Ss          , Ss          , Ss          , Cud         , Cud         , Cud         , Ss          , Ss          , Ss          , Ss          
Xv          , Xv          , Ce          , Ce          , Ce          , Dd          , Dd          , Dd          , Dd          , Dd          , Dd^Xo       , Dd^Xo       , Dd^Xo       , Dd^Xo       , Dd^Xo       , Dd^Xo       , Dd^Xo       , Dd^Xo       , Dd^Xo       , Dd^Xo       , Ss^Xo       , Ss^Xo       , Ss^Xo       , Ss^Xo       , Ss          , Ww          , Ss          , Ww          , Ss          , Ww          , Ww^Bw/      , Ss          , Ss          , Ss          , Cud         , Ss          , Ss          , Ss          , Ss          , Ss          
Xv          , Xv          , Ce          , 3 Ke        , Ce          , Ce          , Dd          , Dd          , Dd          , Dd          , Dd^Xo       , Dd^Xo       , Dd^Xo       , Dd^Xo       , Dd^Xo       , Dd^Xo       , Dd^Xo       , Dd^Xo       , Ss^Xo       , Ss^Xo       , Ss^Xo       , Ss^Xo       , Ss^Xo       , Ss^Xo       , Ss^Xo       , Ss          , Ss          , Ss^Xo       , Ss^Xo       , Ss          , Ww          , Ss^Vhs      , Ss          , Ss          , Ss          , Ss          , Ss          , Ss^Vm       , Ss          , Ss          
Xv          , Xv          , Dd          , Ce          , Dd          , Dd          , Dd^Xo       , Dd^Xo       , Dd^Xo       , Dd          , Dd^Xo       , Dd^Xo       , Dd^Xo       , Dd^Xo       , Dd^Xo       , Dd^Xo       , Ss^Xo       , Ss^Xo       , Ss^Xo       , Ss^Xo       , Ss^Xo       , Ss^Xo       , Ss^Xo       , Ss^Xo       , Ss^Xo       , Ss^Vm       , Ss          , Ss^Xo       , Ss^Xo       , Ss^Xo       , Ss^Xo       , Ww          , Ww          , Ss          , Ss          , Ss          , Ww^Bw/      , Ss          , Ss          , Ss          
Xv          , Xv          , Dd          , Dd          , Dd^Xo       , Dd^Xo       , Dd^Xo       , Dd^Xo       , Dd^Xo       , Dd^Xo       , Dd^Xo       , Dd^Xo       , Dd^Xo       , Dd^Xo       , Ss^Xo       , Ss^Xo       , Ss^Xo       , Ss^Xo       , Ss^Xo       , Ss^Xo       , Ss^Xo       , Ss^Xo       , Ss^Xo       , Ss^Xo       , Ss          , Ss          , Ss^Xo       , Ss^Xo       , Ss^Xo       , Ss^Xo       , Ss^Xo       , Ss^Xo       , Ss^Xo       , Ww          , Ww^Xo       , Ww^Xo       , Ss^Xo       , Ww          , Ww          , Ss          
Xv          , Xv          , Dd^Xo       , Dd^Xo       , Dd^Xo       , Dd^Xo       , Dd^Xo       , Dd^Xo       , Dd^Xo       , Dd^Xo       , Dd^Xo       , Dd^Xo       , Dd^Xo       , Ss^Xo       , Ss^Xo       , Ss^Xo       , Ss^Xo       , Ss^Xo       , Ss^Xo       , Ss^Xo       , Ss^Xo       , Ss^Xo       , Ss^Xo       , Ss          , Ss^Vhs      , Ss^Xo       , Ss^Xo       , Ss^Xo       , Ss^Xo       , Ss^Xo       , Ss^Xo       , Ss^Xo       , Ss^Xo       , Ww^Xo       , Ww^Xo       , Ss^Xo       , Ss^Xo       , Ss^Xo       , Ss          , Ww          
Xv          , Xv          , Dd^Xo       , Dd^Xo       , Dd^Xo       , Dd^Xo       , Dd^Xo       , Dd^Xo       , Dd^Xo       , Dd^Xo       , Dd^Xo       , Dd^Xo       , Ss^Xo       , Ss^Xo       , Ss^Xo       , Ss^Xo       , Ss^Xo       , Ss^Xo       , Ss^Xo       , Ss^Xo       , Ss^Xo       , Ss^Xo       , Ss^Vhs      , Ss          , Ss          , Ss^Xo       , Ss^Xo       , Ss^Xo       , Ss^Xo       , Ss^Xo       , Ss^Xo       , Ss^Xo       , Ss^Xo       , Ss^Xo       , Ww^Xo       , Ss^Xo       , Ww^Xo       , Ss^Xo       , Ss          , Ss          
Xv          , Xv          , Dd^Xo       , Dd^Xo       , Dd^Xo       , Dd^Xo       , Dd^Xo       , Dd^Xo       , Dd^Xo       , Dd^Xo       , Dd^Xo       , Dd^Xo       , Ss^Xo       , Ss^Xo       , Ss^Xo       , Ss^Xo       , Ss^Xo       , Ss^Xo       , Ss^Xo       , Ss^Xo       , Ss^Xo       , Ss^Xo       , Ss          , Ss          , Ss^Vhs      , Ss^Xo       , Ss^Xo       , Ss^Xo       , Ss^Xo       , Ss^Xo       , Ss^Xo       , Ss^Xo       , Ss^Xo       , Ss^Xo       , Ss^Xo       , Ww^Xo       , Ss          , Ww          , Ww          , Ss          
Xv          , Xv          , Dd^Xo       , Dd^Xo       , Dd^Xo       , Dd^Xo       , Dd^Xo       , Dd^Xo       , Dd^Xo       , Dd^Xo       , Dd^Xo       , Ss^Xo       , Ss^Xo       , Ss^Xo       , Ss          , Ss^Xo       , Ss          , Ss^Xo       , Ss          , Ss^Xo       , Ss          , Ss          , Ss          , Ss          , Ss          , Ss          , Ss          , Ss^Xo       , Ss^Xo       , Ss^Xo       , Ss          , Ss^Xo       , Ss          , Ss          , Ss          , Ss          , Ss          , Ss          , Ww          , Ss          
