border_size=1
usage=map

Ss^Fjty     , Ss^Fjty     , Ss^Fjty     , Ss^Fjty     , Ss          , Ss          , Ss^Fjty     , Ss^Fjty     , Ss^Fjty     , Ss^Fjty     , Ss^Fjty     , Ss^Fjty     , Ss^Fjty     , Gg          , Gs^Xo       , Gg          , Gg^Fjty     , Ss^Fjty     , Ss          , Ss          , Ss          , Gg          , Gg          , Gg          , Gg          , Gg          , Gg          , Gg          , Gg          , Gg          , Gg          , Gg          , Gg          , Gg          , Gg          , Gg          , Gg          , Gg          , Gg          
Ss^Fjty     , Ss^Fjty     , Ss^Fjty     , Ss^Yyyy     , Ss^Fjty     , Ss^Fjty     , Ss^Fjty     , Ss^Fjty     , Ss^Fjty     , Ss^Fjty     , Ss^Fjty     , Ss^Fjty     , Gs^Fjty     , Gg^Fjty     , Gg^Fjty     , Gg^Fjty     , Gg^Fjty     , Gg^Fjty     , Gs^Fjty     , Ss          , Gg          , Gs          , Gg          , Gg          , Gg          , Gg          , Gs          , Gg          , Gg          , Gg          , Gg          , Gg          , Gg          , Gg          , Gg          , Gg          , Gg          , Gg          , Gg          
Ss^Fjty     , Ss          , Ss^Fjty     , Ss^Fjty     , Ss^Fjty     , Ss^Fjty     , Ss^Fjty     , Ss^Fjty     , Ss^Fjty     , Ss^Fjty     , Ss^Fjty     , Gg^Fjty     , Gs          , Ss^Fjty     , Gs^Fjty     , Gg^Fjty     , Gg          , Gg          , Gg          , Gs          , Re^Vct      , Dd^Vdt      , 4 Ss        , Gs          , Gg          , Gg          , Gs          , Gg^Yyyy     , Gg          , Gg          , Gg          , Gg          , Gg          , Gg          , Gg          , Gg          , Gg          , Gg          , Ss          
Ss^Fjty     , Ss^Fjty     , Ss^Fjty     , Ss^Fjty     , Ss^Fjty     , Ss          , Ss^Fjty     , Ss^Fjty     , Ss^Fjty     , Ss^Fjty     , Gs          , Gs          , Ss^Fjty     , Ss^Fjty     , Ss          , Gg          , Gg^Fjty     , Gg          , Gg          , Ss          , Ss          , Ss          , Ss          , 1 Ss        , Ss          , Gs          , Ss          , Gs^Yyyy     , Gg          , Gg          , Gg          , Gs          , Ss          , Gs          , Ss^Xo       , Gg          , Ss          , Ss          , Ss          
Ss^Fjty     , Ss^Fjty     , Ss^Fjty     , Ss^Fjty     , Ss^Fjty     , Ss^Fjty     , Ss^Fjty     , Ss^Fjty     , Ss^Fjty     , Ss^Fjty     , Ss^Fjty     , Ss^Fjty     , Ss          , Ss^Fjty     , Ss^Fjty     , Gs^Fjty     , Ss^Fjty     , Ss^Fjty     , Gs^Fjty     , Gg          , Gs^Fjty     , Ss          , Ss          , Ss          , Ce          , Ss          , Ss          , Ss          , Dd^Vdt      , Re^Vct      , Ss          , Ss^Xo       , Ss^Xo       , Ss          , Gg^Xo       , Ss^Xo       , Ss^Xo       , Ss^Xo       , Ss^Xo       
Ss^Fjty     , Ss^Fjty     , Ss^Fjty     , Ss^Fjty     , Rd^Fjty     , Ss          , Rd^Fjty     , Rd^Fjty     , Rd^Fjty     , Ss^Fjty     , Ss^Fjty     , Ss^Fjty     , Ss^Fjty     , Ss^Fjty     , Ss^Fjty     , Ss^Fjty     , Ss^Fjty     , Ss^Fjty     , Ss^Fjty     , Gs^Fjty     , Ss^Fjty     , Ss^Fjty     , Ss          , Ss          , Ss          , Ce          , Ce          , Ke          , Ce          , Ss          , Ss^Xo       , Ss^Xo       , Ss^Xo       , Gg^Xo       , Ss^Xo       , Ss^Xo       , Ss^Xo       , Ss^Xo       , Ss^Xo       
Rd^Fjty     , Rd^Fjty     , Rd^Fjty     , Rd^Fjty     , Rd^Fjty     , Rd^Fjty     , Rd^Fjty     , Rd^Fjty     , Rd^Fjty     , Ss^Fjty     , Rd^Fjty     , Ss^Fjty     , Ss^Fjty     , Ss^Fjty     , Ss^Fjty     , Ss^Fjty     , Ss^Fjty     , Ss^Fjty     , Ss^Fjty     , Ss^Fjty     , Ss^Fjty     , Ss^Fjty     , Ss          , Ss          , Ss          , Ss          , Ss          , Ce          , Ss^Xo       , Ss^Xo       , Ss^Xo       , Ss^Xo       , Ss^Xo       , Ss^Xo       , Ss^Xo       , Ss^Xo       , Ss^Xo       , Ss^Xo       , Ss^Xo       
Rd^Fjty     , Rd^Fjty     , Rd^Fjty     , Rd^Fjty     , Rd^Fjty     , Rd^Fjty     , Rd^Fjty     , Rd^Fjty     , Rd^Fjty     , Rd^Fjty     , Rd^Fjty     , Rd^Fjty     , Rd^Fjty     , Ss^Fjty     , Rd^Fjty     , Ss^Fjty     , Ss^Fjty     , Ss^Fjty     , Ss          , Ss^Fjty     , Ss          , Ss          , Ss          , Ss          , Ss          , Ss^Xo       , Ss^Xo       , Ss^Xo       , Ss^Xo       , Ss^Xo       , Ss^Xo       , Ss^Xo       , Ss^Xo       , Ss^Xo       , Ss^Xo       , Ss^Xo       , Ss^Xo       , Ss^Xo       , Ss^Xo       
Rd^Fjty     , Rd^Xo       , Rd^Xo       , Rd^Fjty     , Rd^Xo       , Rd^Fjty     , Rd^Xo       , Rd^Fjty     , Rd^Xo       , Rd^Fjty     , Rd^Xo       , Rd^Fjty     , Rd^Fjty     , Rd^Fjty     , Rd^Fjty     , Ss^Fjty     , Rd          , Ss          , Rd          , Rd          , Rd          , Ss          , Ss^Xo       , Ss^Xo       , Ss^Xo       , Ss^Xo       , Ss^Xo       , Ss^Xo       , Ss^Xo       , Ss^Xo       , Ss^Xo       , Ss^Xo       , Ss^Xo       , Ss^Xo       , Ss^Xo       , Ss^Xo       , Ss^Xo       , Ss^Xo       , Ss^Xo       
Rd^Xo       , Rd^Xo       , Rd^Xo       , Rd^Xo       , Rd^Xo       , Rd^Xo       , Rd^Xo       , Rd^Xo       , Rd^Xo       , Rd^Xo       , Rd^Xo       , Rd^Xo       , Rd^Xo       , Rd^Fjty     , Rd^Fjty     , Rd          , Rd          , Rd          , Rd          , Rd          , Rd          , Rd          , Rd^Xo       , Ss^Xo       , Ss^Xo       , Ss^Xo       , Ss^Xo       , Ss^Xo       , Ss^Xo       , Ss^Xo       , Ss^Xo       , Ss^Xo       , Ss^Xo       , Ss^Xo       , Ss^Xo       , Ss^Xo       , Ss^Xo       , Ss^Xo       , Ss^Xo       
Rd^Xo       , Rd^Xo       , Rd^Xo       , Rd^Xo       , Rd^Xo       , Rd^Xo       , Rd^Xo       , Rd^Xo       , Rd^Xo       , Wo          , Wo          , Rd^Xo       , Ww          , Rd^Xo       , Rd^Xo       , Rd^Xo       , Rd^Xo       , Rd^Xo       , Rd^Xo       , Rd          , Rd          , Rd          , Rd          , Rd^Xo       , Rd^Xo       , Rd^Xo       , Rd^Xo       , Rd^Xo       , Rd^Xo       , Rd^Xo       , Rd^Xo       , Rd^Xo       , Rd^Xo       , Rd^Xo       , Rd^Xo       , Rd^Xo       , Rd^Xo       , Rd^Xo       , Ss^Xo       
Rd^Xo       , Rd^Xo       , Rd^Xo       , Rd^Xo       , Rd^Xo       , Rd^Xo       , Rd^Xo       , Rd^Xo       , Rd^Xo       , Rd^Xo       , Wo          , Wo          , Wo          , Ww          , Rd^Xo       , Rd^Xo       , Ss^Xo       , Rd^Xo       , Rd          , Rd          , Rd          , Rd          , Rd          , Rd^Xo       , Rd^Xo       , Rd^Xo       , Rd^Xo       , Rd^Xo       , Rd^Xo       , Rd^Xo       , Rd^Xo       , Rd^Xo       , Rd^Xo       , Rd^Xo       , Rd^Xo       , Rd^Xo       , Rd^Xo       , Rd^Xo       , Ss^Xo       
Rd^Xo       , Rd^Xo       , Rd^Xo       , Rd^Xo       , Rd^Xo       , Rd^Xo       , Rd^Xo       , Rd^Xo       , Rd^Xo       , Rd^Xo       , Ww          , Wo          , Ww^Xo       , Rd^Xo       , Rd^Xo       , Ss^Xo       , Ss^Xo       , Rd^Xo       , Rd          , Rd          , Rd          , Rd          , Rd          , Rd^Xo       , Rd^Xo       , Rd^Xo       , Rd^Xo       , Rd^Xo       , Rd^Xo       , Rd^Xo       , Rd^Xo       , Rd^Xo       , Rd^Xo       , Rd^Xo       , Rd^Xo       , Rd^Xo       , Rd^Xo       , Rd^Xo       , Ss^Xo       
Rd^Xo       , Rd^Xo       , Rd^Xo       , Rd^Xo       , Rd^Xo       , Rd^Xo       , Rd^Xo       , Rd^Xo       , Rd^Xo       , Rd^Xo       , Rd^Xo       , Rd^Xo       , Ww          , Dd^Xo       , Dd          , Dd^Xo       , Dd          , Dd^Xo       , Dd          , Rd          , Rd          , Rd          , Rd^Xo       , Rd^Xo       , Ss^Xo       , Rd^Xo       , Rd^Xo       , Rd^Xo       , Rd^Xo       , Rd^Xo       , Rd^Xo       , Rd^Xo       , Rd^Xo       , Rd^Xo       , Rd^Xo       , Rd^Xo       , Rd^Xo       , Rd^Xo       , Ss^Xo       
Rd^Xo       , Rd^Xo       , Rd^Xo       , Rd^Xo       , Rd^Xo       , Rd^Xo       , Rd^Xo       , Rd^Xo       , Dd^Xo       , Dd^Xo       , Dd^Xo       , Dd^Xo       , Dd          , Ww          , Wwf         , Dd          , Ww          , Dd          , Dd          , Dd          , Dd          , Dd          , Dd          , Ss          , Ss^Xo       , Ss^Xo       , Rd^Xo       , Rd^Xo       , Rd^Xo       , Rd^Xo       , Rd^Xo       , Rd^Xo       , Rd^Xo       , Rd^Xo       , Rd^Xo       , Rd^Xo       , Ss^Xo       , Ss^Xo       , Ss^Xo       
Rd^Xo       , Rd^Xo       , Rd^Xo       , Rd^Xo       , Rd^Xo       , Rd^Xo       , Rd^Xo       , Dd^Xo       , Dd^Xo       , Dd^Xo       , Dd          , Dd          , Dd          , Dd          , Dd          , Wwf         , Dd          , Ww          , Ww          , Dd          , Dd          , Dd          , Dd          , Dd          , Dd          , Ss^Xo       , Ss^Xo       , Ss^Xo       , Rd^Xo       , Rd^Xo       , Rd^Xo       , Rd^Xo       , Ss^Xo       , Rd^Xo       , Ss^Xo       , Ss^Xo       , Ss^Xo       , Ss^Xo       , Ss^Xo       
Rd^Xo       , Rd^Xo       , Rd^Xo       , Rd^Xo       , Dd^Xo       , Rd^Xo       , Dd^Xo       , Dd^Xo       , Dd          , Dd          , Dd          , Dd          , Dd          , Dd          , Dd          , Dd          , Dd          , Dd          , Wwf         , Dd          , Dd          , Dd          , Dd          , Dd          , Dd          , Ss          , Ss          , Ss^Xo       , Ss^Xo       , Ss^Xo       , Ss^Xo       , Ss^Xo       , Ss^Fjty     , Ss^Fjty     , Ss^Fjty     , Ss^Xo       , Ss^Xo       , Ss^Xo       , Ss^Fjty     
Rd^Xo       , Rd^Xo       , Dd^Xo       , Dd^Xo       , Dd^Xo       , Dd^Xo       , Dd          , Dd          , Dd          , Dd          , Dd          , Dd          , Dd          , Dd          , Dd          , Dd          , Dd          , 2 Dd        , Dd          , Wwf         , Dd          , Ss          , Ss^Fjty     , Dd^Fjty     , Dd          , Ss          , Ss          , Ss          , Ss          , Ss^Xo       , Ss          , Ss^Xo       , Ss^Fjty     , Ss^Fjty     , Ss^Fjty     , Ss^Fjty     , Ss^Fjty     , Ss^Fjty     , Ss^Fjty     
Dd^Xo       , Dd^Xo       , Dd^Xo       , Dd^Xo       , Re^Vct      , Dd          , Dd          , Dd^Do       , Dd          , Dd          , Dd          , Dd          , Dd          , Dd          , Dd          , Dd          , Dd          , Dd          , Dd          , Ww          , Ss          , Dd          , Ss^Fjty     , Ss^Fjty     , Ss^Fjty     , Ss          , Ss          , Ss          , Ss          , Ss          , Ss          , Ss^Fjty     , Ss^Fjty     , Ss^Fjty     , Ss^Fjty     , Ss^Fjty     , Ss^Fjty     , Ss^Fjty     , Ss^Fjty     
Dd          , Dd          , Dd^Vdt      , Dd          , Dd          , Dd          , Dd          , Dd          , Dd          , Dd          , Dd          , Dd          , Dd          , Dd          , Dd          , Dd          , Dd          , Dd          , Dd          , Ww          , Ss          , Ss          , Ss^Fjty     , Ss^Fjty     , Ss^Fjty     , Ss^Fjty     , Ss^Fjty     , Ss          , Ss          , Ss          , Ss          , Ss          , Cud         , Ss^Fjty     , Ss^Fjty     , Ss^Fjty     , Ss^Fjty     , Ss^Fjty     , Ss^Fjty     
Dd          , Dd          , Dd          , Dd          , Dd          , Dd          , Dd          , Dd          , Dd^Esd      , Dd          , Dd          , Dd          , Dd          , Dd          , Dd^Esd      , Dd          , Dd          , Dd          , Dd          , Wwf         , Ww          , Ss          , Ss          , Ss^Fjty     , Ss^Fjty     , Ss^Fjty     , Ss          , Ss          , Ss          , Ss          , Ss          , Ss          , Cud         , Ss          , Cud         , Ss          , Cud         , Ss          , Ss          
Dd          , Dd          , Dd^Vdt      , Dd^Vdt      , Dd          , Dd          , Dd          , Dd          , Dd          , Dd          , Dd          , Dd          , Dd          , Dd^Do       , Dd          , Dd          , Dd          , Dd          , Dd          , Dd          , Dd^Xo       , Ww          , Ww          , Ss          , Ss          , Ss          , Ss          , Ss          , Ss          , Ss          , Ss          , Cud         , Ss          , Cud         , Kud         , Cud         , Ss          , Cud         , Ss          
Dd          , Dd          , Dd          , Dd          , Dd          , Dd          , Dd          , Dd          , Re^Vct      , Dd          , Dd          , Dd          , Dd^Xo       , Dd^Xo       , Dd^Xo       , Dd^Xo       , Dd^Xo       , Dd          , Dd^Xo       , Dd^Xo       , Ss^Xo       , Ss^Xo       , Ss^Xo       , Ww          , Ww          , Ww          , Ww          , Ss          , Ww          , Ss          , Ss          , Ss          , Ss          , Cud         , Cud         , Cud         , Ss          , Ss          , Ss          
Dd          , Dd          , Ce          , Ce          , Ce          , Dd          , Dd          , Dd          , Dd          , Dd          , Dd^Xo       , Dd^Xo       , Dd^Xo       , Dd^Xo       , Dd^Xo       , Dd^Xo       , Dd^Xo       , Dd^Xo       , Dd^Xo       , Dd^Xo       , Ss^Xo       , Ss^Xo       , Ss^Xo       , Ss^Xo       , Ss          , Ww          , Ss^Vm       , Ww          , Ss          , Ww          , Ww^Bw/      , Ss          , Ss          , Ss          , Cud         , Ss          , Ss          , Ss          , Ss          
Dd          , Dd          , Ce          , 3 Ke        , Ce          , Ce          , Dd          , Dd          , Dd          , Dd          , Dd^Xo       , Dd^Xo       , Dd^Xo       , Dd^Xo       , Dd^Xo       , Dd^Xo       , Dd^Xo       , Dd^Xo       , Ss^Xo       , Ss^Xo       , Ss^Xo       , Ss^Xo       , Ss^Xo       , Ss^Xo       , Ss^Xo       , Ss          , Ss          , Ss          , Ss^Fjty     , Ss          , Ww          , Ss^Vhs      , Ss          , Ss          , Ss          , Ss          , Ss          , Ss^Vm       , Ss          
Dd          , Dd          , Dd          , Ce          , Dd          , Dd          , Dd^Xo       , Dd^Xo       , Dd^Xo       , Dd          , Dd^Xo       , Dd^Xo       , Dd^Xo       , Dd^Xo       , Dd^Xo       , Dd^Xo       , Ss^Xo       , Ss^Xo       , Ss^Xo       , Ss^Xo       , Ss^Xo       , Ss^Xo       , Ss^Xo       , Ss^Xo       , Ss^Xo       , Ss          , Ss          , Ss^Fjty     , Ss^Fjty     , Ss^Fjty     , Ss          , Ww          , Ww          , Ss          , Ss          , Ss          , Ww^Bw/      , Ss          , Ss          
Dd          , Dd          , Dd          , Dd          , Dd^Xo       , Dd^Xo       , Dd^Xo       , Dd^Xo       , Dd^Xo       , Dd^Xo       , Dd^Xo       , Dd^Xo       , Dd^Xo       , Dd^Xo       , Ss^Xo       , Ss^Xo       , Ss^Xo       , Ss^Xo       , Ss^Xo       , Ss^Xo       , Ss^Xo       , Ss^Xo       , Ss^Xo       , Ss^Xo       , Ss          , Ss^Vhs      , Ss^Fjty     , Ss^Fjty     , Ss^Fjty     , Ss^Fjty     , Ss^Fjty     , Ss^Fjty     , Ss          , Ww          , Ww          , Ww          , Ss^Fjty     , Ww          , Ww^Fjty     
Dd          , Dd          , Dd^Xo       , Dd^Xo       , Dd^Xo       , Dd^Xo       , Dd^Xo       , Dd^Xo       , Dd^Xo       , Dd^Xo       , Dd^Xo       , Dd^Xo       , Dd^Xo       , Ss^Xo       , Ss^Xo       , Ss^Xo       , Ss^Xo       , Ss^Xo       , Ss^Xo       , Ss^Xo       , Ss^Xo       , Ss^Xo       , Ss          , Ss^Vhs      , Ss          , Ss^Fjty     , Ss^Fjty     , Ss^Fjty     , Ss^Fjty     , Ss^Fjty     , Ss          , Ss^Fjty     , Ss^Fjty     , Ww^Ewf      , Ww^Ewl      , Ss^Fjty     , Ss^Fjty     , Ss^Fjty     , Ss^Fjty     
Dd          , Dd^Xo       , Dd^Xo       , Dd^Xo       , Dd^Xo       , Dd^Xo       , Dd^Xo       , Dd^Xo       , Dd^Xo       , Dd^Xo       , Dd^Xo       , Dd^Xo       , Ss^Xo       , Ss^Xo       , Ss^Xo       , Ss^Xo       , Ss^Xo       , Ss^Xo       , Ss^Xo       , Ss^Xo       , Ss^Xo       , Ss^Xo       , Ss          , Ss          , Ss^Vhs      , Ss^Fjty     , Ss^Fjty     , Ss^Fjty     , Ss^Fjty     , Ss^Fjty     , Ss^Fjty     , Ss^Fjty     , Ss^Fjty     , Ss^Fjty     , Ww^Ewl      , Ss^Fjty     , Ww^Fjty     , Ss^Fjty     , Ss^Fjty     
Dd^Xo       , Dd^Xo       , Dd^Xo       , Dd^Xo       , Dd^Xo       , Dd^Xo       , Dd^Xo       , Dd^Xo       , Dd^Xo       , Dd^Xo       , Dd^Xo       , Dd^Xo       , Ss^Xo       , Ss^Xo       , Ss^Xo       , Ss^Xo       , Ss^Xo       , Ss^Xo       , Ss^Xo       , Ss^Xo       , Ss^Xo       , Ss^Xo       , Ss          , Ss          , Ss          , Ss^Fjty     , Ss^Fjty     , Ss^Fjty     , Ss^Fjty     , Ss^Fjty     , Ss^Fjty     , Ss^Fjty     , Ss^Fjty     , Ss^Fjty     , Ss^Fjty     , Ww          , Ss^Fjty     , Ww^Fjty     , Ww^Fjty     
