border_size=1
usage=map

Xv          , Xv          , Xv          , Xv          , Xv          , Xv          , Xv          , Xv          , Xv          , Xv          , Xv          , Xv          , Xv          , Xv          , Xv          , Xv          , Xv          , Xv          , Xv          , Xv          , Xv          , Xv          , Xv          , Xv          , Xv          , Xv          , Xv          , Xv          , Xv          , Xv          , Xv          , Xv          , Xv          , Xv          , Xv          , Xv          , Xv          , Xv          , Xv          
Xv          , Xv          , Xv          , Xv          , Xv          , Xv          , Xv          , Xv          , Xv          , Xv          , Xv          , Xv          , Xv          , Xv          , Xv          , Xv          , Xv          , Xv          , Xv          , Xv          , Xv          , Xv          , Xv          , Xv          , Xv          , Xv          , Xv          , Xv          , Xv          , Xv          , Xv          , Xv          , Xv          , Xv          , Xv          , Xv          , Xv          , Xv          , Xv          
Xv          , Xv          , Xv          , Xv          , Xv          , Xv          , Xv          , Xv          , Xv          , Xv          , Xv          , Xv          , Xv          , Xv          , Xv          , Xv          , Xv          , Xv          , Xv          , Xv          , Xv          , Xv          , Xv          , Xv          , Xv          , Xv          , Xv          , Xv          , Xv          , Xv          , Xv          , Xv          , Xv          , Xv          , Xv          , Xv          , Xv          , Xv          , Xv          
Xv          , Xv          , Xv          , Xv          , Xv          , Xv          , Xv          , Xv          , Xv          , Xv          , Xv          , Xv          , Xv          , Xv          , Xv          , Xv          , Xv          , Xv          , Xv          , Xv          , Xv          , Xv          , Xv          , Xv          , Xv          , Xv          , Xv          , Xv          , Xv          , Xv          , Xv          , Xv          , Xv          , Xv          , Xv          , Xv          , Xv          , Xv          , Xv          
Xv          , Xv          , Xv          , Xv          , Xv          , Xv          , Xv          , Xv          , Xv          , Xv          , Xv          , Xv          , Xv          , Xv          , Xv          , Xv          , Xv          , Xv          , Xv          , Xv          , Xv          , Xv          , Xv          , Xv          , Xv          , Xv          , Xv          , Xv          , Xv          , Xv          , Xv          , Xv          , Xv          , Xv          , Xv          , Xv          , Xv          , Xv          , Xv          
Xv          , Xv          , Xv          , Xv          , Xv          , Xv          , Xv          , Xv          , Xv          , Xv          , Xv          , Xv          , Xv          , Xv          , Xv          , Xv          , Xv          , Xv          , Xv          , Xv          , Xv          , Xv          , Xv          , Xv          , Xv          , Xv          , Xv          , Xv          , Xv          , Xv          , Xv          , Xv          , Xv          , Xv          , Xv          , Xv          , Xv          , Xv          , Xv          
Xv          , Xv          , Xv          , Xv          , Xv          , Xv          , Xv          , Xv          , Xv          , Xv          , Xv          , Xv          , Xv          , Xv          , Xv          , Xv          , Xv          , Xv          , Xv          , Xv          , Xv          , Xv          , Xv          , Xv          , Xv          , Xv          , Xv          , Xv          , Xv          , Xv          , Xv          , Xv          , Xv          , Xv          , Xv          , Xv          , Xv          , Xv          , Xv          
Xv          , Xv          , Xv          , Xv          , Xv          , Xv          , Xv          , Xv          , Xv          , Xv          , Xv          , Xv          , Xv          , Xv          , Xv          , Xv          , Xv          , Xv          , Xv          , Xv          , Xv          , Xv          , Xv          , Xv          , Xv          , Xv          , Xv          , Xv          , Xv          , Xv          , Xv          , Xv          , Xv          , Xv          , Xv          , Xv          , Xv          , Xv          , Xv          
Xv          , Xv          , Xv          , Xv          , Xv          , Xv          , Xv          , Xv          , Xv          , Xv          , Xv          , Xv          , Xv          , Xv          , Xv          , Xv          , Xv          , Xv          , Xv          , Xv          , Xv          , Xv          , Xv          , Xv          , Xv          , Xv          , Xv          , Xv          , Xv          , Xv          , Xv          , Xv          , Xv          , Xv          , Xv          , Xv          , Xv          , Xv          , Xv          
Xv          , Xv          , Xv          , Xv          , Xv          , Xv          , Xv          , Xv          , Xv          , Xv          , Xv          , Xv          , Xv          , Xv          , Xv          , Xv          , Xv          , Xv          , Xv          , Xv          , Xv          , Xv          , Xv          , Xv          , Xv          , Xv          , Xv          , Xv          , Xv          , Xv          , Xv          , Xv          , Xv          , Xv          , Xv          , Xv          , Xv          , Xv          , Xv          
Xv          , Xv          , Xv          , Xv          , Xv          , Xv          , Xv          , Xv          , Xv          , Xv          , Xv          , Xv          , Xv          , Xv          , Xv          , Xv          , Xv          , Xv          , Xv          , Xv          , Xv          , Xv          , Xv          , Xv          , Xv          , Xv          , Xv          , Xv          , Xv          , Xv          , Xv          , Xv          , Xv          , Xv          , Xv          , Xv          , Xv          , Xv          , Xv          
Xv          , Xv          , Xv          , Xv          , Xv          , Xv          , Xv          , Xv          , Xv          , Xv          , Xv          , Xv          , Xv          , Xv          , Xv          , Xv          , Xv          , Xv          , Xv          , Xv          , Rd          , Xv          , Xv          , Xv          , Xv          , Xv          , Xv          , Xv          , Xv          , Xv          , Xv          , Xv          , Xv          , Xv          , Xv          , Xv          , Xv          , Xv          , Xv          
Xv^Xo       , Xv          , Xv          , Xv          , Xv          , Xv          , Xv          , Xv          , Xv          , Xv          , Xv          , Xv          , Xv          , Xv          , Xv          , Xv          , Dd^Xo       , Dd^Xo       , Xv          , Rd          , Rd          , Rd          , Xv          , Rd^Xo       , Rd^Xo       , Rd^Xo       , Rd^Xo       , Rd^Xo       , Rd^Xo       , Xv          , Xv          , Xv          , Xv          , Xv          , Xv          , Xv          , Xv          , Xv          , Xv          
Xv^Xo       , Xv          , Xv          , Xv          , Dd^Xo       , Xv          , Dd^Xo       , Dd^Xo       , Dd^Xo       , Dd^Xo       , Dd^Xo       , Xv          , Dd^Xo       , Xv          , Dd^Xo       , Dd^Xo       , Dd^Vdt      , Dd          , Dd          , Dd          , Dd          , Dd          , Dd          , Dd          , Dd          , Dd          , Dd          , Dd          , Dd          , Rd^Xo       , Rd^Xo       , Rd^Xo       , Rd^Xo       , Rd^Xo       , Rd^Xo       , Rd^Xo       , Rd^Xo       , Xv          , Xv          
Xv          , Xv          , Dd^Xo       , Dd^Xo       , Dd          , Dd^Xo       , Dd          , Dd          , Dd          , Dd          , Dd          , Dd^Xo       , Dd          , Dd^Xo       , Dd          , Dd          , Dd          , Dd          , Dd^Cov      , Dd^Cov      , 2 Dd^Kov    , Dd^Cov      , Dd^Cov      , Dd          , Dd          , Dd          , Dd          , Dd          , Dd          , Dd          , Dd          , Dd          , Dd          , Dd          , Dd          , Dd          , Rd^Xo       , Xv          , Xv          
Xv          , Xv          , Dd          , Dd          , Dd          , Dd          , Dd          , Dd          , Dd          , Dd          , Dd          , Dd          , Dd          , Dd          , Dd          , Dd^Vdt      , Dd          , Dd^Do       , Dd          , Dd^Cov      , Dd^Cov      , Dd^Cov      , Dd          , Dd          , Dd          , Dd^Vdt      , Dd          , Dd^Do       , Dd          , Dd          , Dd          , Dd          , Dd          , Dd          , Hd          , Rd^Xo       , Xv          , Xv          , Xv          
Xv^Xo       , Xv          , Dd          , Dd          , Dd          , Dd          , Dd          , Dd          , Dd          , Dd          , Dd          , Dd          , Dd          , Dd          , Dd          , Dd          , Dd          , Dd          , Dd^Vdt      , Dd          , Dd          , Dd          , Dd          , Dd^Vdt      , Dd          , Dd          , Dd          , Dd          , Dd          , Dd          , Dd          , Hd          , Dd          , Dd          , Dd          , Rd^Xo       , Xv          , Xv          , Xv          
Xv^Xo       , Xv          , Dd          , Dd          , Dd          , Dd          , Dd          , Dd          , Dd          , Dd          , Hd          , Hd          , Dd          , Dd          , Dd          , Dd          , Dd          , Dd          , Dd          , Dd          , Dd          , Dd          , Dd          , Dd          , Dd          , Dd          , Dd          , Dd          , Hd          , Hd          , Dd          , Dd          , Dd          , Hd          , Dd          , Rd^Xo       , Rd^Xo       , Xv          , Xv          
Xv          , Xv          , Dd          , Dd          , Dd          , Dd          , Dd          , Dd          , Hd          , Dd^Do       , Dd          , Dd          , Hd          , Hd          , Dd          , Dd          , Dd          , Dd          , Dd          , Dd          , Dd          , Dd          , Hd          , Dd          , Dd          , Dd          , Dd          , Dd          , Md          , Dd          , Dd          , Dd          , Hd          , Dd          , Dd          , Dd          , Hd          , Xv          , Xv          
Xv          , Xv          , Dd          , Dd          , Dd          , Dd          , Dd          , Dd          , Hd          , Dd          , Md          , Md          , Md          , Dd^Do       , Dd          , Dd          , Dd          , Hd          , Dd          , Dd          , Hd          , Dd          , Dd          , Dd          , Dd          , Dd          , Dd          , Md          , Hd          , Hd          , Dd^Do       , Dd          , Md          , Dd          , Dd          , Hd          , Dd          , Xv          , Xv          
Xv          , Xv          , Dd          , Dd          , Dd          , Dd          , Dd          , Dd          , Md          , Md          , Dd          , Md          , Dd          , Dd          , Dd          , Dd          , Dd          , Dd          , Hd          , Hd          , Dd          , Dd          , Dd^Do       , Dd          , Dd          , Dd          , Dd          , Dd          , Dd          , Hd          , Dd          , Dd          , Md          , Md          , Hd          , Dd          , Dd          , Xv          , Xv          
Xv          , Xv          , Dd          , Dd          , Dd          , Dd          , Hd          , Hd          , Md          , Dd          , Hd          , Hd          , Dd          , Dd          , Dd          , Dd          , Dd^Vdt      , Hd          , Dd          , Dd          , Dd          , Dd          , Dd          , Dd          , Dd          , Dd          , Dd          , Dd          , Dd          , Dd          , Md          , Md          , Md          , Hd          , Dd          , Dd          , Dd          , Xv          , Xv          
Xv          , Xv          , Dd          , Dd          , Dd          , Dd          , Dd          , Hd          , Md          , Dd          , Hd          , Hd          , Dd          , Dd          , Hd          , Hd          , Md          , Hd          , Hd          , Dd          , Dd          , Dd          , Dd          , Dd          , Dd          , Dd^Vdt      , Dd          , Dd          , Hd          , Md          , Md          , Hd          , Hd          , Hd          , Dd          , Dd          , Xuq         , Xuq         , Xuq         
Xv          , Xv          , Dd          , Dd          , Dd          , Dd          , Dd          , Hd          , Hd          , Md          , Dd          , Dd          , Dd^Do       , Dd          , Hd          , Md          , Dd          , Dd          , Dd^Vda      , Dd          , Dd          , Dd          , Dd          , Dd          , Dd          , Dd          , Dd          , Dd          , Hd          , Md          , Hd          , Hd          , Dd          , Dd          , Xuq         , Xuq         , Xuq         , Xuq         , Xuq         
Xuq         , Xuq         , Xuq         , Dd          , Dd          , Dd          , Dd          , Dd          , Dd          , Dd          , Dd          , Dd          , Dd          , Dd          , Hd          , Md          , Dd          , Dd          , Dd          , Dd          , Dd          , Dd          , Dd          , Dd          , Dd^Vda      , Dd          , Dd          , Md          , Hd          , Hd          , Dd^Do       , Dd          , Dd          , Xuq         , Xuq         , Xuq         , Xuq         , Xuq         , Xuq         
Xuq         , Xuq         , Xuq         , Dd          , Xuq         , Dd          , Dd          , Dd          , Dd          , Dd          , Dd          , Dd          , Dd          , Dd          , Dd          , Dd^Vda      , Dd          , Hd          , Dd          , Dd          , Dd^Kov      , Dd          , Dd          , Dd          , Dd          , Dd          , Hd          , Dd          , Dd          , Dd          , Dd          , Dd          , Xuq         , Xuq         , Xuq         , Xuq         , Xuq         , Xuq         , Xuq         
Xuq         , Xuq         , Xuq         , Xuq         , Xuq         , Xuq         , Xuq         , Xuq         , Xuq         , Xuq         , Xuq         , Xuq         , Xuq         , Dd          , Dd          , Dd          , Xuq         , Xuq         , Dd^Cov      , Dd^Cov      , Dd          , Dd^Cov      , Dd^Cov      , Dd          , Dd          , Dd          , Dd          , Dd          , Dd          , Dd          , Xuq         , Xuq         , Xuq         , Xuq         , Xuq         , Xuq         , Xuq         , Xuq         , Xuq         
Xuq         , Xuq         , Xuq         , Xuq         , Xuq         , Xuq         , Xuq         , Xuq         , Xuq         , Xuq         , Xuq         , Xuq         , Xuq         , Xuq         , Xuq         , Xuq         , Xuq         , Xuq         , Xuq         , Dd          , 1 Dd        , Dd          , Xuq         , Xuq         , Xuq         , Dd          , Xuq         , Xuq         , Xuq         , Xuq         , Xuq         , Xuq         , Xuq         , Xuq         , Xuq         , Xuq         , Xuq         , Xuq         , Xuq         
Xuq         , Xuq         , Xuq         , Xuq         , Xuq         , Xuq         , Xuq         , Xuq         , Xuq         , Xuq         , Xuq         , Xuq         , Xuq         , Xuq         , Xuq         , Xuq         , Xuq         , Xuq         , Xuq         , Dd          , Dd          , Dd          , Xuq         , Xuq         , Xuq         , Xuq         , Xuq         , Xuq         , Xuq         , Xuq         , Xuq         , Xuq         , Xuq         , Xuq         , Xuq         , Xuq         , Xuq         , Xuq         , Xuq         
