border_size=1
usage=map

Qxu^Xo      , Qxu^Xo      , Qxu^Xo      , Qxu^Xo      , Qxu^Xo      , Qxu^Xo      , Qxu^Xo      , Qxu^Xo      , Qxu^Xo      , Qxu^Xo      , Qxu^Xo      , Qxu^Xo      , Qxu^Xo      , Qxu^Xo      , Qxu^Xo      , Qxu^Xo      , Qxu^Xo      , Qxu^Xo      , Qxu^Xo      , Qxu^Xo      , Qxu^Xo      , Qxu^Xo      , Qxu^Xo      , Qxu^Xo      , Qxu^Xo      , Qxu^Xo      , Qxu^Xo      , Qxu^Xo      , Qxu^Xo      , Qxu^Xo      , Qxu^Xo      , Qxu^Xo      , Qxu^Xo      , Qxu^Xo      , Qxu^Xo      , Qxu^Xo      , Qxu^Xo      , Qxu^Xo      , Qxu^Xo      , Qxu^Xo      , Qxu^Xo      , Qxu^Xo      , Qxu^Xo      , Qxu^Xo      , Qxu^Xo      , Qxu^Xo      , Qxu^Xo      , Qxu^Xo      
Qxu^Xo      , Qxu^Xo      , Qxu^Xo      , Qxu^Xo      , Qxu^Xo      , Qxu^Xo      , Qxu^Xo      , Qxu^Xo      , Qxu^Xo      , Qxu^Xo      , Qxu^Xo      , Qxu^Xo      , Qxu^Xo      , Qxu^Xo      , Qxu^Xo      , Qxu^Xo      , Qxu^Xo      , Qxu^Xo      , Qxu^Xo      , Qxu^Xo      , Qxu^Xo      , Qxu^Xo      , Qxu^Xo      , Qxu^Xo      , Qxu^Xo      , Qxu^Xo      , Qxu^Xo      , Qxu^Xo      , Qxu^Xo      , Qxu^Xo      , Qxu^Xo      , Qxu^Xo      , Qxu^Xo      , Qxu^Xo      , Qxu^Xo      , Qxu^Xo      , Qxu^Xo      , Qxu^Xo      , Qxu^Xo      , Qxu^Xo      , Qxu^Xo      , Qxu^Xo      , Qxu^Xo      , Qxu^Xo      , Qxu^Xo      , Qxu^Xo      , Qxu^Xo      , Qxu^Xo      
Qxu^Xo      , Qxu^Xo      , Qxu^Xo      , Qxu^Xo      , Qxu^Xo      , Qxu^Xo      , Qxu^Xo      , Qxu^Xo      , Qxu^Xo      , Qxu^Xo      , Qxu^Xo      , Qxu^Xo      , Qxu^Xo      , Qxu^Xo      , Qxu^Xo      , Qxu^Xo      , Qxu^Xo      , Qxu^Xo      , Qxu^Xo      , Qxu^Xo      , Qxu^Xo      , Qxu^Xo      , Qxu^Xo      , Qxu^Xo      , Qxu^Xo      , Qxu^Xo      , Qxu^Xo      , Qxu^Xo      , Qxu^Xo      , Qxu^Xo      , Qxu^Xo      , Qxu^Xo      , Qxu^Xo      , Qxu^Xo      , Qxu^Xo      , Qxu^Xo      , Qxu^Xo      , Qxu^Xo      , Qxu^Xo      , Qxu^Xo      , Qxu^Xo      , Qxu^Xo      , Qxu^Xo      , Qxu^Xo      , Qxu^Xo      , Qxu^Xo      , Qxu^Xo      , Qxu^Xo      
Qxu^Xo      , Qxu^Xo      , Qxu^Xo      , Qxu^Xo      , Qxu^Xo      , Qxu^Xo      , Qxu^Xo      , Qxu^Xo      , Qxu^Xo      , Qxu^Xo      , Qxu^Xo      , Qxu^Xo      , Qxu^Xo      , Qxu^Xo      , Qxu^Xo      , Qxu^Xo      , Qxu^Xo      , Qxu^Xo      , Qxu^Xo      , Qxu^Xo      , Qxu^Xo      , Qxu^Xo      , Ur          , Ur          , Qxu^Xo      , Qxu^Xo      , Qxu^Xo      , Qxu^Xo      , Qxu^Xo      , Qxu^Xo      , Qxu^Xo      , Qxu^Xo      , Qxu^Xo      , Qxu^Xo      , Qxu^Xo      , Qxu^Xo      , Qxu^Xo      , Qxu^Xo      , Qxu^Xo      , Qxu^Xo      , Qxu^Xo      , Qxu^Xo      , Qxu^Xo      , Qxu^Xo      , Qxu^Xo      , Qxu^Xo      , Qxu^Xo      , Qxu^Xo      
Qxu^Xo      , Qxu^Xo      , Qxu^Xo      , Qxu^Xo      , Qxu^Xo      , Qxu^Xo      , Qxu^Xo      , Qxu^Xo      , Qxu^Xo      , Qxu^Xo      , Qxu^Xo      , Qxu^Xo      , Qxu^Xo      , Qxu^Xo      , Qxu^Xo      , Qxu^Xo      , Qxu^Xo      , Qxu^Xo      , Qxu^Xo      , Qxu^Xo      , Ur          , Ur          , Qxu^Xo      , Qxu^Xo      , Qxu^Xo      , Qxu^Xo      , Qxu^Xo      , Qxu^Xo      , Qxu^Xo      , Qxu^Xo      , Qxu^Xo      , Qxu^Xo      , Qxu^Xo      , Qxu^Xo      , Qxu^Xo      , Qxu^Xo      , Qxu^Xo      , Qxu^Xo      , Qxu^Xo      , Qxu^Xo      , Qxu^Xo      , Qxu^Xo      , Qxu^Xo      , Qxu^Xo      , Qxu^Xo      , Qxu^Xo      , Qxu^Xo      , Qxu^Xo      
Qxu^Xo      , Qxu^Xo      , Qxu^Xo      , Qxu^Xo      , Qxu^Xo      , Qxu^Xo      , Qxu^Xo      , Qxu^Xo      , Qxu^Xo      , Qxu^Xo      , Qxu^Xo      , Qxu^Xo      , Qxu^Xo      , Qxu^Xo      , Qxu^Xo      , Qxu^Xo      , Qxu^Xo      , Qxu^Xo      , Ur          , Ur          , Qxu^Xo      , Qxu^Xo      , Qxu^Xo      , Qxu^Xo      , Qxu^Xo      , Qxu^Xo      , Qxu^Xo      , Qxu^Xo      , Qxu^Xo      , Qxu^Xo      , Qxu^Xo      , Qxu^Xo      , Qxu^Xo      , Qxu^Xo      , Qxu^Xo      , Qxu^Xo      , Qxu^Xo      , Qxu^Xo      , Qxu^Xo      , Qxu^Xo      , Qxu^Xo      , Qxu^Xo      , Qxu^Xo      , Qxu^Xo      , Qxu^Xo      , Qxu^Xo      , Qxu^Xo      , Qxu^Xo      
Qxu^Xo      , Qxu^Xo      , Qxu^Xo      , Qxu^Xo      , Qxu^Xo      , Qxu^Xo      , Qxu^Xo      , Qxu^Xo      , Qxu^Xo      , Qxu^Xo      , Qxu^Xo      , Qxu^Xo      , Qxu^Xo      , Qxu^Xo      , Qxu^Xo      , Qxu^Xo      , Ur          , Ur          , Qxu^Xo      , Qxu^Xo      , Qxu^Xo      , Qxu^Xo      , Qxu^Xo      , Qxu^Xo      , Qxu^Xo      , Qxu^Xo      , Qxu^Xo      , Qxu^Xo      , Qxu^Xo      , Qxu^Xo      , Qxu^Xo      , Qxu^Xo      , Qxu^Xo      , Qxu^Xo      , Qxu^Xo      , Qxu^Xo      , Qxu^Xo      , Qxu^Xo      , Qxu^Xo      , Qxu^Xo      , Qxu^Xo      , Qxu^Xo      , Qxu^Xo      , Qxu^Xo      , Qxu^Xo      , Qxu^Xo      , Qxu^Xo      , Qxu^Xo      
Qxu^Xo      , Qxu^Xo      , Qxu^Xo      , Qxu^Xo      , Qxu^Xo      , Qxu^Xo      , Qxu^Xo      , Qxu^Xo      , Qxu^Xo      , Qxu^Xo      , Qxu^Xo      , Qxu^Xo      , Qxu^Xo      , Qxu^Xo      , Ur          , Ur          , Qxu^Xo      , Qxu^Xo      , Qxu^Xo      , Qxu^Xo      , Qxu^Xo      , Qxu^Xo      , Qxu^Xo      , Qxu^Xo      , Qxu^Xo      , Qxu^Xo      , Qxu^Xo      , Qxu^Xo      , Qxu^Xo      , Qxu^Xo      , Qxu^Xo      , Qxu^Xo      , Qxu^Xo      , Qxu^Xo      , Qxu^Xo      , Qxu^Xo      , Qxu^Xo      , Qxu^Xo      , Qxu^Xo      , Qxu^Xo      , Qxu^Xo      , Qxu^Xo      , Qxu^Xo      , Qxu^Xo      , Qxu^Xo      , Qxu^Xo      , Qxu^Xo      , Qxu^Xo      
Qxu^Xo      , Qxu^Xo      , Qxu^Xo      , Qxu^Xo      , Qxu^Xo      , Qxu^Xo      , Qxu^Xo      , Qxu^Xo      , Qxu^Xo      , Qxu^Xo      , Qxu^Xo      , Qxu^Xo      , Ur          , Ur          , Qxu^Xo      , Qxu^Xo      , Qxu^Xo      , Qxu^Xo      , Qxu^Xo      , Qxu^Xo      , Qxu^Xo      , Qxu^Xo      , Qxu^Xo      , Qxu^Xo      , Qxu^Xo      , Qxu^Xo      , Qxu^Xo      , Qxu^Xo      , Qxu^Xo      , Qxu^Xo      , Qxu^Xo      , Qxu^Xo      , Qxu^Xo      , Qxu^Xo      , Qxu^Xo      , Qxu^Xo      , Qxu^Xo      , Qxu^Xo      , Qxu^Xo      , Qxu^Xo      , Qxu^Xo      , Qxu^Xo      , Qxu^Xo      , Qxu^Xo      , Qxu^Xo      , Qxu^Xo      , Qxu^Xo      , Qxu^Xo      
Qxu^Xo      , Qxu^Xo      , Qxu^Xo      , Qxu^Xo      , Qxu^Xo      , Qxu^Xo      , Qxu^Xo      , Qxu^Xo      , Qxu^Xo      , Qxu^Xo      , Ur          , Ur          , Qxu^Xo      , Qxu^Xo      , Qxu^Xo      , Qxu^Xo      , Qxu^Xo      , Qxu^Xo      , Qxu^Xo      , Qxu^Xo      , Qxu^Xo      , Qxu^Xo      , Qxu^Xo      , Qxu^Xo      , Qxu^Xo      , Qxu^Xo      , Qxu^Xo      , Qxu^Xo      , Qxu^Xo      , Qxu^Xo      , Qxu^Xo      , Qxu^Xo      , Qxu^Xo      , Qxu^Xo      , Qxu^Xo      , Qxu^Xo      , Qxu^Xo      , Qxu^Xo      , Qxu^Xo      , Qxu^Xo      , Qxu^Xo      , Qxu^Xo      , Qxu^Xo      , Qxu^Xo      , Qxu^Xo      , Qxu^Xo      , Qxu^Xo      , Qxu^Xo      
Qxu^Xo      , Qxu^Xo      , Qxu^Xo      , Qxu^Xo      , Qxu^Xo      , Qxu^Xo      , Qxu^Xo      , Qxu^Xo      , Qxu^Xo      , Ur          , Qxu^Xo      , Qxu^Xo      , Qxu^Xo      , Qxu^Xo      , Qxu^Xo      , Qxu^Xo      , Qxu^Xo      , Qxu^Xo      , Qxu^Xo      , Qxu^Xo      , Qxu^Xo      , Qxu^Xo      , Qxu^Xo      , Qxu^Xo      , Qxu^Xo      , Qxu^Xo      , Qxu^Xo      , Qxu^Xo      , Qxu^Xo      , Qxu^Xo      , Qxu^Xo      , Qxu^Xo      , Qxu^Xo      , Qxu^Xo      , Qxu^Xo      , Qxu^Xo      , Qxu^Xo      , Qxu^Xo      , Qxu^Xo      , Qxu^Xo      , Qxu^Xo      , Qxu^Xo      , Qxu^Xo      , Qxu^Xo      , Qxu^Xo      , Qxu^Xo      , Qxu^Xo      , Qxu^Xo      
Qxu^Xo      , Qxu^Xo      , Qxu^Xo      , Qxu^Xo      , Qxu^Xo      , Qxu^Xo      , Qxu^Xo      , Qxu^Xo      , Ur          , Ur          , Qxu^Xo      , Qxu^Xo      , Qxu^Xo      , Qxu^Xo      , Qxu^Xo      , Qxu^Xo      , Qxu^Xo      , Qxu^Xo      , Qxu^Xo      , Qxu^Xo      , Qxu^Xo      , Qxu^Xo      , Qxu^Xo      , Qxu^Xo      , Qxu^Xo      , Qxu^Xo      , Qxu^Xo      , Qxu^Xo      , Qxu^Xo      , Qxu^Xo      , Qxu^Xo      , Qxu^Xo      , Qxu^Xo      , Qxu^Xo      , Qxu^Xo      , Qxu^Xo      , Qxu^Xo      , Qxu^Xo      , Qxu^Xo      , Qxu^Xo      , Qxu^Xo      , Qxu^Xo      , Qxu^Xo      , Qxu^Xo      , Qxu^Xo      , Qxu^Xo      , Qxu^Xo      , Qxu^Xo      
Qxu^Xo      , Qxu^Xo      , Qxu^Xo      , Qxu^Xo      , Qxu^Xo      , Qxu^Xo      , Qxu^Xo      , Ur          , Ur          , Qxu^Xo      , Qxu^Xo      , Qxu^Xo      , Qxu^Xo      , Qxu^Xo      , Qxu^Xo      , Qxu^Xo      , Qxu^Xo      , Qxu^Xo      , Qxu^Xo      , Qxu^Xo      , Qxu^Xo      , Qxu^Xo      , Qxu^Xo      , Qxu^Xo      , Qxu^Xo      , Qxu^Xo      , Qxu^Xo      , Qxu^Xo      , Qxu^Xo      , Qxu^Xo      , Qxu^Xo      , Qxu^Xo      , Qxu^Xo      , Qxu^Xo      , Qxu^Xo      , Qxu^Xo      , Qxu^Xo      , Qxu^Xo      , Qxu^Xo      , Qxu^Xo      , Qxu^Xo      , Qxu^Xo      , Qxu^Xo      , Qxu^Xo      , Qxu^Xo      , Qxu^Xo      , Qxu^Xo      , Qxu^Xo      
Qxu^Xo      , Qxu^Xo      , Qxu^Xo      , Qxu^Xo      , Qxu^Xo      , Qxu^Xo      , Ur          , Ur          , Qxu^Xo      , Qxu^Xo      , Qxu^Xo      , Qxu^Xo      , Qxu^Xo      , Qxu^Xo      , Qxu^Xo      , Qxu^Xo      , Qxu^Xo      , Qxu^Xo      , Qxu^Xo      , Qxu^Xo      , Qxu^Xo      , Qxu^Xo      , Qxu^Xo      , Qxu^Xo      , Qxu^Xo      , Qxu^Xo      , Qxu^Xo      , Qxu^Xo      , Qxu^Xo      , Qxu^Xo      , Qxu^Xo      , Qxu^Xo      , Qxu^Xo      , Qxu^Xo      , Qxu^Xo      , Qxu^Xo      , Qxu^Xo      , Qxu^Xo      , Qxu^Xo      , Qxu^Xo      , Qxu^Xo      , Qxu^Xo      , Qxu^Xo      , Qxu^Xo      , Qxu^Xo      , Qxu^Xo      , Qxu^Xo      , Qxu^Xo      
Qxu^Xo      , Qxu^Xo      , Qxu^Xo      , Qxu^Xo      , Qxu^Xo      , Qxu^Xo      , Ur          , Qxu^Xo      , Qxu^Xo      , Qxu^Xo      , Qxu^Xo      , Qxu^Xo      , Qxu^Xo      , Qxu^Xo      , Qxu^Xo      , Qxu^Xo      , Qxu^Xo      , Qxu^Xo      , Qxu^Xo      , Qxu^Xo      , Qxu^Xo      , Qxu^Xo      , Qxu^Xo      , Qxu^Xo      , Qxu^Xo      , Qxu^Xo      , Qxu^Xo      , Qxu^Xo      , Qxu^Xo      , Qxu^Xo      , Qxu^Xo      , Qxu^Xo      , Qxu^Xo      , Qxu^Xo      , Qxu^Xo      , Qxu^Xo      , Qxu^Xo      , Qxu^Xo      , Qxu^Xo      , Qxu^Xo      , Qxu^Xo      , Qxu^Xo      , Qxu^Xo      , Qxu^Xo      , Qxu^Xo      , Qxu^Xo      , Qxu^Xo      , Qxu^Xo      
Qxu^Xo      , Qxu^Xo      , Qxu^Xo      , Qxu^Xo      , Qxu^Xo      , Qxu^Xo      , Qxu^Xo      , Ur          , Ur          , Qxu^Xo      , Qxu^Xo      , Qxu^Xo      , Qxu^Xo      , Qxu^Xo      , Qxu^Xo      , Qxu^Xo      , Qxu^Xo      , Qxu^Xo      , Qxu^Xo      , Qxu^Xo      , Qxu^Xo      , Qxu^Xo      , Qxu^Xo      , Qxu^Xo      , Qxu^Xo      , Qxu^Xo      , Qxu^Xo      , Qxu^Xo      , Qxu^Xo      , Qxu^Xo      , Qxu^Xo      , Qxu^Xo      , Qxu^Xo      , Qxu^Xo      , Qxu^Xo      , Qxu^Xo      , Qxu^Xo      , Qxu^Xo      , Qxu^Xo      , Qxu^Xo      , Qxu^Xo      , Qxu^Xo      , Qxu^Xo      , Qxu^Xo      , Qxu^Xo      , Qxu^Xo      , Qxu^Xo      , Qxu^Xo      
Qxu^Xo      , Qxu^Xo      , Qxu^Xo      , Qxu^Xo      , Qxu^Xo      , Qxu^Xo      , Ur          , Ur          , Ur          , Ur          , Qxu^Xo      , Qxu^Xo      , Qxu^Xo      , Qxu^Xo      , Qxu^Xo      , Qxu^Xo      , Qxu^Xo      , Qxu^Xo      , Qxu^Xo      , Qxu^Xo      , Qxu^Xo      , Qxu^Xo      , Qxu^Xo      , Qxu^Xo      , Qxu^Xo      , Qxu^Xo      , Qxu^Xo      , Qxu^Xo      , Qxu^Xo      , Qxu^Xo      , Qxu^Xo      , Qxu^Xo      , Qxu^Xo      , Qxu^Xo      , Qxu^Xo      , Qxu^Xo      , Qxu^Xo      , Qxu^Xo      , Qxu^Xo      , Qxu^Xo      , Qxu^Xo      , Qxu^Xo      , Qxu^Xo      , Qxu^Xo      , Qxu^Xo      , Qxu^Xo      , Qxu^Xo      , Qxu^Xo      
Qxu^Xo      , Qxu^Xo      , Qxu^Xo      , Qxu^Xo      , Qxu^Xo      , Qxu^Xo      , Qxu^Xo      , Ur          , Ur          , Ur          , Ur          , Qxu^Xo      , Qxu^Xo      , Qxu^Xo      , Qxu^Xo      , Qxu^Xo      , Qxu^Xo      , Qxu^Xo      , Qxu^Xo      , Qxu^Xo      , Qxu^Xo      , Qxu^Xo      , Qxu^Xo      , Qxu^Xo      , Qxu^Xo      , Qxu^Xo      , Ur          , Ur          , Ur          , Qxu^Xo      , Qxu^Xo      , Qxu^Xo      , Qxu^Xo      , Qxu^Xo      , Qxu^Xo      , Qxu^Xo      , Qxu^Xo      , Qxu^Xo      , Qxu^Xo      , Qxu^Xo      , Qxu^Xo      , Qxu^Xo      , Qxu^Xo      , Qxu^Xo      , Qxu^Xo      , Qxu^Xo      , Qxu^Xo      , Qxu^Xo      
Qxu^Xo      , Qxu^Xo      , Qxu^Xo      , Qxu^Xo      , Qxu^Xo      , Qxu^Xo      , Qxu^Xo      , Qxu^Xo      , Qxu^Xo      , Ur          , Ur          , Ur          , Ur          , Qxu^Xo      , Qxu^Xo      , Qxu^Xo      , Qxu^Xo      , Qxu^Xo      , Qxu^Xo      , Qxu^Xo      , Qxu^Xo      , Qxu^Xo      , Qxu^Xo      , Qxu^Xo      , Cud         , Cud         , Ur          , Ur          , Ur          , Ur          , Ur          , Qxu^Xo      , Qxu^Xo      , Qxu^Xo      , Qxu^Xo      , Qxu^Xo      , Qxu^Xo      , Qxu^Xo      , Qxu^Xo      , Qxu^Xo      , Qxu^Xo      , Qxu^Xo      , Qxu^Xo      , Qxu^Xo      , Qxu^Xo      , Qxu^Xo      , Qxu^Xo      , Qxu^Xo      
Qxu^Xo      , Qxu^Xo      , Qxu^Xo      , Qxu^Xo      , Qxu^Xo      , Qxu^Xo      , Qxu^Xo      , Qxu^Xo      , Qxu^Xo      , Ur          , Ur          , Ur          , Qxu^Xo      , Qxu^Xo      , Qxu^Xo      , Qxu^Xo      , Qxu^Xo      , Qxu^Xo      , Qxu^Xo      , Qxu^Xo      , Qxu^Xo      , Qxu^Xo      , Ur          , Ur          , Cud         , Cud         , Kud         , Ur          , 2 Ur        , Ur          , Ur          , Ur          , Ur          , Qxu^Xo      , Qxu^Xo      , Qxu^Xo      , Qxu^Xo      , Qxu^Xo      , Qxu^Xo      , Qxu^Xo      , Qxu^Xo      , Qxu^Xo      , Qxu^Xo      , Qxu^Xo      , Qxu^Xo      , Qxu^Xo      , Qxu^Xo      , Qxu^Xo      
Qxu^Xo      , Qxu^Xo      , Qxu^Xo      , Qxu^Xo      , Qxu^Xo      , Qxu^Xo      , Qxu^Xo      , Qxu^Xo      , Qxu^Xo      , Qxu^Xo      , Qxu^Xo      , Qxu^Xo      , Qxu^Xo      , Qxu^Xo      , Qxu^Xo      , Qxu^Xo      , Qxu^Xo      , Qxu^Xo      , Qxu^Xo      , Qxu^Xo      , Cud         , Ur          , Ur          , Cud         , Ur          , Ur          , Ur          , Ur          , Ur          , Ur          , Ur          , Ur          , Ur          , Ur          , Ur          , Qxu^Xo      , Qxu^Xo      , Qxu^Xo      , Qxu^Xo      , Qxu^Xo      , Qxu^Xo      , Qxu^Xo      , Qxu^Xo      , Qxu^Xo      , Qxu^Xo      , Qxu^Xo      , Qxu^Xo      , Qxu^Xo      
Qxu^Xo      , Qxu^Xo      , Qxu^Xo      , Qxu^Xo      , Qxu^Xo      , Qxu^Xo      , Qxu^Xo      , Qxu^Xo      , Qxu^Xo      , Qxu^Xo      , Qxu^Xo      , Qxu^Xo      , Qxu^Xo      , Qxu^Xo      , Qxu^Xo      , Qxu^Xo      , Qxu^Xo      , Qxu^Xo      , Uu^Vud      , Ur          , Ur          , Ur          , Ur          , Ur          , Ur          , Ur          , Ur          , Ur          , Ur          , Kud         , Cud         , Ur          , Cud         , Ur          , Qxu^Xo      , Qxu^Xo      , Qxu^Xo      , Qxu^Xo      , Qxu^Xo      , Qxu^Xo      , Qxu^Xo      , Qxu^Xo      , Qxu^Xo      , Qxu^Xo      , Qxu^Xo      , Qxu^Xo      , Qxu^Xo      , Qxu^Xo      
Qxu^Xo      , Qxu^Xo      , Qxu^Xo      , Qxu^Xo      , Qxu^Xo      , Qxu^Xo      , Qxu^Xo      , Qxu^Xo      , Qxu^Xo      , Qxu^Xo      , Qxu^Xo      , Qxu^Xo      , Qxu^Xo      , Qxu^Xo      , Qxu^Xo      , Qxu^Xo      , Ur          , Ur          , Ur          , Ur          , Ur          , Ur          , Ur          , Ur          , Ur          , Ur          , Ur          , Ur          , Cud         , Cud         , Ur          , Cud         , Qxu^Xo      , Qxu^Xo      , Qxu^Xo      , Qxu^Xo      , Qxu^Xo      , Qxu^Xo      , Qxu^Xo      , Qxu^Xo      , Qxu^Xo      , Qxu^Xo      , Qxu^Xo      , Qxu^Xo      , Qxu^Xo      , Qxu^Xo      , Qxu^Xo      , Qxu^Xo      
Qxu^Xo      , Qxu^Xo      , Qxu^Xo      , Qxu^Xo      , Qxu^Xo      , Qxu^Xo      , Qxu^Xo      , Qxu^Xo      , Qxu^Xo      , Qxu^Xo      , Qxu^Xo      , Qxu^Xo      , Qxu^Xo      , Qxu^Xo      , Ur          , Cud         , Ur          , Ur          , Ur          , Ur          , Ur          , Ur          , Ur          , Ur          , Ur          , Ur          , Ur          , Ur          , Ur          , Ur          , Qxu^Xo      , Qxu^Xo      , Qxu^Xo      , Qxu^Xo      , Qxu^Xo      , Qxu^Xo      , Qxu^Xo      , Qxu^Xo      , Qxu^Xo      , Qxu^Xo      , Qxu^Xo      , Qxu^Xo      , Qxu^Xo      , Qxu^Xo      , Qxu^Xo      , Qxu^Xo      , Qxu^Xo      , Qxu^Xo      
Qxu^Xo      , Qxu^Xo      , Qxu^Xo      , Qxu^Xo      , Qxu^Xo      , Qxu^Xo      , Qxu^Xo      , Qxu^Xo      , Qxu^Xo      , Qxu^Xo      , Qxu^Xo      , Qxu^Xo      , Ur          , Uu^Vud      , Ur          , Ur          , Ur          , Ur          , Ur          , Ur          , Ur          , Ur          , Ur          , Ur          , Ur          , Ur          , Ur          , Cud         , Qxu^Xo      , Qxu^Xo      , Qxu^Xo      , Qxu^Xo      , Qxu^Xo      , Qxu^Xo      , Qxu^Xo      , Qxu^Xo      , Qxu^Xo      , Qxu^Xo      , Qxu^Xo      , Qxu^Xo      , Qxu^Xo      , Qxu^Xo      , Qxu^Xo      , Qxu^Xo      , Qxu^Xo      , Qxu^Xo      , Qxu^Xo      , Qxu^Xo      
Qxu^Xo      , Qxu^Xo      , Qxu^Xo      , Qxu^Xo      , Qxu^Xo      , Qxu^Xo      , Qxu^Xo      , Qxu^Xo      , Qxu^Xo      , Qxu^Xo      , Uu^Vud      , Ur          , Ur          , Ur          , Ur          , Ur          , Ur          , Ur          , Ur          , Ur          , Ur          , Ur          , Ur          , Ur          , Ur          , Uu^Vud      , Qxu^Xo      , Qxu^Xo      , Qxu^Xo      , Qxu^Xo      , Qxu^Xo      , Qxu^Xo      , Qxu^Xo      , Qxu^Xo      , Qxu^Xo      , Qxu^Xo      , Qxu^Xo      , Qxu^Xo      , Qxu^Xo      , Qxu^Xo      , Qxu^Xo      , Qxu^Xo      , Qxu^Xo      , Qxu^Xo      , Qxu^Xo      , Qxu^Xo      , Qxu^Xo      , Qxu^Xo      
Qxu^Xo      , Qxu^Xo      , Qxu^Xo      , Qxu^Xo      , Qxu^Xo      , Qxu^Xo      , Qxu^Xo      , Qxu^Xo      , Ur          , Ur          , Ur          , Ur          , Ur          , Ur          , Ur          , Ur          , Ur          , Ur          , Ur          , Ur          , Ur          , Ur          , Cud         , Ur          , Qxu^Xo      , Qxu^Xo      , Qxu^Xo      , Qxu^Xo      , Qxu^Xo      , Qxu^Xo      , Qxu^Xo      , Qxu^Xo      , Qxu^Xo      , Qxu^Xo      , Qxu^Xo      , Qxu^Xo      , Qxu^Xo      , Qxu^Xo      , Qxu^Xo      , Qxu^Xo      , Qxu^Xo      , Qxu^Xo      , Qxu^Xo      , Qxu^Xo      , Qxu^Xo      , Qxu^Xo      , Qxu^Xo      , Qxu^Xo      
Qxu^Xo      , Qxu^Xo      , Qxu^Xo      , Qxu^Xo      , Qxu^Xo      , Qxu^Xo      , Ur          , Ur          , Ur          , Ur          , Ur          , Ur          , Ur          , Ur          , Ur          , Ur          , Ur          , Ur          , Ur          , Ur          , Uu^Vud      , Ur          , Qxu^Xo      , Qxu^Xo      , Qxu^Xo      , Qxu^Xo      , Qxu^Xo      , Qxu^Xo      , Qxu^Xo      , Qxu^Xo      , Qxu^Xo      , Qxu^Xo      , Qxu^Xo      , Qxu^Xo      , Qxu^Xo      , Qxu^Xo      , Qxu^Xo      , Qxu^Xo      , Qxu^Xo      , Qxu^Xo      , Qxu^Xo      , Qxu^Xo      , Qxu^Xo      , Qxu^Xo      , Qxu^Xo      , Qxu^Xo      , Qxu^Xo      , Qxu^Xo      
Qxu^Xo      , Qxu^Xo      , Qxu^Xo      , Qxu^Xo      , Ur          , Ur          , Ur          , Ur          , Ur          , Ur          , Ur          , Ur          , Ur          , Ur          , Ur          , Ur          , Ur          , Ur          , Ur          , Ur          , Qxu^Xo      , Qxu^Xo      , Qxu^Xo      , Qxu^Xo      , Qxu^Xo      , Qxu^Xo      , Qxu^Xo      , Qxu^Xo      , Qxu^Xo      , Qxu^Xo      , Qxu^Xo      , Qxu^Xo      , Qxu^Xo      , Qxu^Xo      , Qxu^Xo      , Qxu^Xo      , Qxu^Xo      , Qxu^Xo      , Qxu^Xo      , Qxu^Xo      , Qxu^Xo      , Qxu^Xo      , Qxu^Xo      , Qxu^Xo      , Qxu^Xo      , Qxu^Xo      , Qxu^Xo      , Qxu^Xo      
Qxu^Xo      , Qxu^Xo      , Cud         , Ur          , Ur          , Ur          , Ur          , Ur          , Ur          , Ur          , Ur          , Ur          , Ur          , Ur          , Ur          , Ur          , Ur          , Uu^Vud      , Qxu^Xo      , Qxu^Xo      , Qxu^Xo      , Qxu^Xo      , Qxu^Xo      , Qxu^Xo      , Qxu^Xo      , Qxu^Xo      , Qxu^Xo      , Qxu^Xo      , Qxu^Xo      , Qxu^Xo      , Qxu^Xo      , Qxu^Xo      , Qxu^Xo      , Qxu^Xo      , Qxu^Xo      , Qxu^Xo      , Qxu^Xo      , Qxu^Xo      , Qxu^Xo      , Qxu^Xo      , Qxu^Xo      , Qxu^Xo      , Qxu^Xo      , Qxu^Xo      , Qxu^Xo      , Qxu^Xo      , Qxu^Xo      , Qxu^Xo      
Ur          , Cud         , Ur          , Cud         , Kud         , Ur          , Ur          , Ur          , Ur          , Ur          , Ur          , Ur          , Ur          , Ur          , Ur          , Ur          , Qxu^Xo      , Qxu^Xo      , Qxu^Xo      , Qxu^Xo      , Qxu^Xo      , Qxu^Xo      , Qxu^Xo      , Qxu^Xo      , Qxu^Xo      , Qxu^Xo      , Qxu^Xo      , Qxu^Xo      , Qxu^Xo      , Qxu^Xo      , Qxu^Xo      , Qxu^Xo      , Qxu^Xo      , Qxu^Xo      , Qxu^Xo      , Qxu^Xo      , Qxu^Xo      , Qxu^Xo      , Qxu^Xo      , Qxu^Xo      , Qxu^Xo      , Qxu^Xo      , Qxu^Xo      , Qxu^Xo      , Qxu^Xo      , Qxu^Xo      , Qxu^Xo      , Qxu^Xo      
Ur          , Ur          , Ur          , Ur          , Ur          , Ur          , Ur          , Ur          , Ur          , Ur          , Ur          , Ur          , Ur          , Ur          , Qxu^Xo      , Qxu^Xo      , Qxu^Xo      , Qxu^Xo      , Qxu^Xo      , Qxu^Xo      , Qxu^Xo      , Qxu^Xo      , Qxu^Xo      , Qxu^Xo      , Qxu^Xo      , Qxu^Xo      , Qxu^Xo      , Qxu^Xo      , Qxu^Xo      , Qxu^Xo      , Qxu^Xo      , Qxu^Xo      , Qxu^Xo      , Qxu^Xo      , Qxu^Xo      , Qxu^Xo      , Qxu^Xo      , Qxu^Xo      , Qxu^Xo      , Qxu^Xo      , Qxu^Xo      , Qxu^Xo      , Qxu^Xo      , Qxu^Xo      , Qxu^Xo      , Qxu^Xo      , Qxu^Xo      , Qxu^Xo      
Ur          , Ur          , Ur          , Ur          , 1 Ur        , Ur          , Ur          , Kud         , Cud         , Ur          , Ur          , Ur          , Qxu^Xo      , Qxu^Xo      , Qxu^Xo      , Qxu^Xo      , Qxu^Xo      , Qxu^Xo      , Qxu^Xo      , Qxu^Xo      , Qxu^Xo      , Qxu^Xo      , Qxu^Xo      , Qxu^Xo      , Qxu^Xo      , Qxu^Xo      , Qxu^Xo      , Qxu^Xo      , Qxu^Xo      , Qxu^Xo      , Qxu^Xo      , Qxu^Xo      , Qxu^Xo      , Qxu^Xo      , Qxu^Xo      , Qxu^Xo      , Qxu^Xo      , Qxu^Xo      , Qxu^Xo      , Qxu^Xo      , Qxu^Xo      , Qxu^Xo      , Qxu^Xo      , Qxu^Xo      , Qxu^Xo      , Qxu^Xo      , Qxu^Xo      , Qxu^Xo      
Ur          , Ur          , Ur          , Ur          , Ur          , Ur          , Ur          , Ur          , Cud         , Cud         , Qxu^Xo      , Qxu^Xo      , Qxu^Xo      , Qxu^Xo      , Qxu^Xo      , Qxu^Xo      , Qxu^Xo      , Qxu^Xo      , Qxu^Xo      , Qxu^Xo      , Qxu^Xo      , Qxu^Xo      , Qxu^Xo      , Qxu^Xo      , Qxu^Xo      , Qxu^Xo      , Qxu^Xo      , Qxu^Xo      , Qxu^Xo      , Qxu^Xo      , Qxu^Xo      , Qxu^Xo      , Qxu^Xo      , Qxu^Xo      , Qxu^Xo      , Qxu^Xo      , Qxu^Xo      , Qxu^Xo      , Qxu^Xo      , Qxu^Xo      , Qxu^Xo      , Qxu^Xo      , Qxu^Xo      , Qxu^Xo      , Qxu^Xo      , Qxu^Xo      , Qxu^Xo      , Qxu^Xo      
Ur          , Ur          , Ur          , Ur          , Ur          , Ur          , Ur          , Ur          , Qxu^Xo      , Qxu^Xo      , Qxu^Xo      , Qxu^Xo      , Qxu^Xo      , Qxu^Xo      , Qxu^Xo      , Qxu^Xo      , Qxu^Xo      , Qxu^Xo      , Qxu^Xo      , Qxu^Xo      , Qxu^Xo      , Qxu^Xo      , Qxu^Xo      , Qxu^Xo      , Qxu^Xo      , Qxu^Xo      , Qxu^Xo      , Qxu^Xo      , Qxu^Xo      , Qxu^Xo      , Qxu^Xo      , Qxu^Xo      , Qxu^Xo      , Qxu^Xo      , Qxu^Xo      , Qxu^Xo      , Qxu^Xo      , Qxu^Xo      , Qxu^Xo      , Qxu^Xo      , Qxu^Xo      , Qxu^Xo      , Qxu^Xo      , Qxu^Xo      , Qxu^Xo      , Qxu^Xo      , Qxu^Xo      , Qxu^Xo      
Ur          , Ur          , Ur          , Ur          , Ur          , Ur          , Qxu^Xo      , Qxu^Xo      , Qxu^Xo      , Qxu^Xo      , Qxu^Xo      , Qxu^Xo      , Qxu^Xo      , Qxu^Xo      , Qxu^Xo      , Qxu^Xo      , Qxu^Xo      , Qxu^Xo      , Qxu^Xo      , Qxu^Xo      , Qxu^Xo      , Qxu^Xo      , Qxu^Xo      , Qxu^Xo      , Qxu^Xo      , Qxu^Xo      , Qxu^Xo      , Qxu^Xo      , Qxu^Xo      , Qxu^Xo      , Qxu^Xo      , Qxu^Xo      , Qxu^Xo      , Qxu^Xo      , Qxu^Xo      , Qxu^Xo      , Qxu^Xo      , Qxu^Xo      , Qxu^Xo      , Qxu^Xo      , Qxu^Xo      , Qxu^Xo      , Qxu^Xo      , Qxu^Xo      , Qxu^Xo      , Qxu^Xo      , Qxu^Xo      , Qxu^Xo      
