border_size=1
usage=map

Xv          , Xv          , Xv          , Xv          , Xv          , Xv          , Xv          , Xv          , Xv          , Xv          , Xv          , Xv          , Xv          , Xv          , Xv          , Xv          , Xv          , Xv          , Xv          , Xv          , Xv          , Xv          , Xv          , Xv          , Xv          , Xv          , Xv          , Xv          , Xv          , Xv          , Xv          , Xv          , Xv          , Xv          , Xv          , Xv          , Xv          , Xv          , Xv          
Xv          , Xv          , Xv          , Xv          , Xv          , Xv          , Xv          , Xv          , Xv          , Xv          , Xv          , Xv          , Xv          , Xv          , Xv          , Xv          , Xv          , Xv          , Xv          , Xv          , Xv          , Xv          , Xv          , Xv          , Xv          , Xv          , Xv          , Xv          , Xv          , Xv          , Xv          , Xv          , Xv          , Xv          , Xv          , Xv          , Xv          , Xv          , Xv          
Xv          , Xv          , Rr          , Xv          , Xv          , Xv          , Xv          , Xv          , Rr          , Rr          , Rr          , Rr          , Rr          , Rr          , Rr          , Rr          , Rr          , Rp          , Rp          , Rp          , Rp          , Rp          , Rr          , Rr          , Rr          , Rr          , Rr          , Rr          , Rr          , Rr          , Rr          , Xv          , Xv          , Xv          , Xv          , Xv          , Rr          , Xv          , Xv          
Xv          , Xv          , Rr          , Rr          , Rr          , Xv          , Rr          , Rr          , Rr          , Rr          , Rr          , Rr          , Rr          , Rr          , Rr          , Rr          , Rr          , Rp          , Rp          , Rp          , Rp          , Rp          , Rr          , Rr          , Rr          , Rr          , Rr          , Rr          , Rr          , Rr          , Rr          , Rr          , Rr          , Xv          , Rr          , Rr          , Rr          , Xv          , Xv          
Xv          , Xv          , Rr          , Rr          , Rr          , Rr          , Rr          , Rr          , Rr          , Rr          , Rr          , Rr          , Rr          , Rr          , Rr          , Rr          , Rr          , Rp          , Rp          , Rp          , Rp          , Rp          , Rr          , Rr          , Rr          , Rr          , Rr          , Rr          , Rr          , Rr          , Rr          , Rr          , Rr          , Rr          , Rr          , Rr          , Rr          , Xv          , Xv          
Xv          , Xv          , Rr          , Rr          , Rr          , Rr          , Rr          , Rr          , Rr          , Rr          , Xv          , Rr          , Xv          , Xv          , Xv          , Rr          , Xv          , Rp          , Rp          , Rp          , Rp          , Rp          , Xv          , Rr          , Xv          , Xv          , Xv          , Rr          , Xv          , Rr          , Rr          , Rr          , Rr          , Rr          , Rr          , Rr          , Rr          , Xv          , Xv          
Xv          , Xv          , Rr          , Rr          , Rr          , Rr          , Rr          , Rr          , Rr          , Rr          , Xv          , Xv          , Xv          , Xv          , Xv          , Xv          , Xv          , Rp          , Rp          , Rp          , Rp          , Rp          , Xv          , Xv          , Xv          , Xv          , Xv          , Xv          , Xv          , Rr          , Rr          , Rr          , Rr          , Rr          , Rr          , Rr          , Rr          , Xv          , Xv          
Xv          , Xv          , Rr          , Rr          , Rr          , Rr          , Rr          , Rr          , Rr          , Rr          , Xv          , Xv          , Xv          , Xv          , Xv          , Xv          , Xv          , Rp          , Rp          , Rp          , Rp          , Rp          , Xv          , Xv          , Xv          , Xv          , Xv          , Xv          , Xv          , Rr          , Rr          , Rr          , Rr          , Rr          , Rr          , Rr          , Rr          , Xv          , Xv          
Xv          , Xv          , Gg^Xo       , Gg^Xo       , Gg^Xo       , Gg^Xo       , Gg^Xo       , Gg^Xo       , Gg^Xo       , Gg^Xo       , Xv          , Xv          , Xv          , Xv          , Xv          , Xv          , Xv          , Rp          , Rp          , Rp          , Rp          , Rp          , Xv          , Xv          , Xv          , Xv          , Xv          , Xv          , Xv          , Gg^Xo       , Gg^Xo       , Gg^Xo       , Gg^Xo       , Gg^Xo       , Gg^Xo       , Gg^Xo       , Gg^Xo       , Xv          , Xv          
Xv          , Xv          , Rr          , Rr          , Rr          , Rr          , 6 Rr        , Rr          , Rr          , Rr          , Rr          , Xv          , Xv          , Xv          , Xv          , Xv          , Rp          , Rp          , Rp          , Rp          , Rp          , Rp          , Rp          , Xv          , Xv          , Xv          , Xv          , Xv          , Rr          , Rr          , Rr          , Rr          , Rr          , Rr          , Rr          , Rr          , Rr          , Xv          , Xv          
Xv          , Xv          , Xv          , Xv          , Xv          , Xv          , Xv          , Xv          , Xv          , Xv          , Xv          , Xv          , Xv          , Xv          , Xv          , Xv          , Rp          , Rp          , Rp          , Rp          , Rp          , Rp          , Rp          , Xv          , Xv          , Xv          , Xv          , Xv          , Xv          , Xv          , Xv          , Xv          , Xv          , Xv          , Xv          , Xv          , Xv          , Xv          , Xv          
Xv          , Xv          , Xv          , Xv          , Xv          , Xv          , Xv          , Xv          , Xv          , Xv          , Xv          , Xv          , Xv          , Xv          , Xv          , Xv          , Rp          , Rp          , Rp          , Rp          , Rp          , Rp          , Rp          , Xv          , Xv          , Xv          , Xv          , Xv          , Xv          , Xv          , Xv          , Xv          , Xv          , Xv          , Xv          , Xv          , Xv          , Xv          , Xv          
Xv          , Xv          , Xv          , Xv          , Xv          , Xv          , Xv          , Xv          , Xv          , Xv          , Xv          , Xv          , Xv          , Xv          , Xv          , Xv          , Rp          , Rp          , Rp          , Rp          , Rp          , Rp          , Rp          , Xv          , Xv          , Xv          , Xv          , Xv          , Xv          , Xv          , Xv          , Xv          , Xv          , Xv          , Xv          , Xv          , Xv          , Xv          , Xv          
Xv          , Xv          , Xv          , Xv          , Xv          , Xv          , Xv          , Xv          , Xv          , Xv          , Xv          , Xv          , Xv          , Xv          , Xv          , Xv          , Rp          , Rp          , Rp          , Rp          , Rp          , Rp          , Rp          , Xv          , Xv          , Xv          , Xv          , Xv          , Xv          , Xv          , Xv          , Xv          , Xv          , Xv          , Xv          , Xv          , Xv          , Xv          , Xv          
Xv          , Xv          , Xv          , Xv          , Xv          , Xv          , Xv          , Xv          , Xv          , Xv          , Xv          , Xv          , Xv          , Xv          , Xv          , Xv          , Rp          , Rp          , Rp          , Rp          , Rp          , Rp          , Rp          , Xv          , Xv          , Xv          , Xv          , Xv          , Xv          , Xv          , Xv          , Xv          , Xv          , Xv          , Xv          , Xv          , Xv          , Xv          , Xv          
Xv          , Xv          , Xv          , Xv          , Xv          , Xv          , Xv          , Xv          , Xv          , Xv          , Xv          , Xv          , Xv          , Xv          , Xv          , Xv          , Rp          , Rp          , Rp          , Rp          , Rp          , Rp          , Rp          , Xv          , Xv          , Xv          , Xv          , Xv          , Xv          , Xv          , Xv          , Xv          , Xv          , Xv          , Xv          , Xv          , Xv          , Xv          , Xv          
Xv          , Xv          , Xv          , Xv          , Xv          , Xv          , Xv          , Xv          , Xv          , Xv          , Xv          , Xv          , Xv          , Xv          , Xv          , Xv          , Rp          , Rp          , Rp          , Rp          , Rp          , Rp          , Rp          , Xv          , Xv          , Xv          , Xv          , Xv          , Xv          , Xv          , Xv          , Xv          , Xv          , Xv          , Xv          , Xv          , Xv          , Xv          , Xv          
Xv          , Xv          , Gg^Xo       , Xv          , Gg^Xo       , Xv          , Gg^Xo       , Xv          , Gg^Xo       , Xv          , Gg^Xo       , Xv          , Xv          , Xv          , Xv          , Xv          , Rp          , Rp          , Rp          , Rp          , Rp          , Rp          , Rp          , Xv          , Xv          , Xv          , Xv          , Xv          , Gg^Xo       , Xv          , Gg^Xo       , Xv          , Gg^Xo       , Xv          , Gg^Xo       , Xv          , Gg^Xo       , Xv          , Gg^Xo       
Xv          , Gg          , Gg^Vc       , Gg          , Gs^Vht      , Gg          , Gs^Fms      , Gg          , Gs^Vht      , Gs^Vht      , Gg          , Gg^Xo       , Gg          , Xv          , Gg^Xo       , Gg^Xo       , Rp          , Rp          , Rp          , Rp          , Rp          , Rp          , Rp          , Gg^Xo       , Gg^Xo       , Xv          , Gg^Xo       , Gg^Xo       , Gg          , Gg          , Gs^Vht      , Gg          , Rd          , Gg          , Gs^Fms      , Gg          , Gg^Vc       , Gg          , Gg          
Xv          , Gg          , Rd          , Rd          , Rd          , Rd          , Rd          , Rd          , Rd          , Re^Gvs      , Rd          , Gg          , Gs^Fms      , Gg          , Gg          , Gg          , Rp          , Rp          , Rp          , Rp          , Rp          , Rp          , Rp          , Gg          , Rd          , Gg          , Rd          , Gs^Vht      , Gs^Vht      , Hh          , Rd          , Gs^Fms      , Rd          , Gs^Fms      , Rd          , Rd          , Gs^Fms      , Hh          , Gg          
Xv          , Rd          , Re^Gvs      , Re^Gvs      , Re^Gvs      , Re^Gvs      , Re^Gvs      , Re^Gvs      , Re^Gvs      , Rd          , Rd          , Rd          , Rd          , Rd          , Rd          , Rd          , Rp          , Rp          , Rp          , Rp          , Rp          , Rp          , Rp          , Rd          , Hh          , Rd          , Hh          , Rd          , Rd          , Rd          , Re^Gvs      , Rd          , Re^Gvs      , Re^Gvs      , Re^Gvs      , Re^Gvs      , Gs^Fms      , Hh          , Gg          
Xv          , Re^Gvs      , Re^Gvs      , Re^Gvs      , Gs^Fms      , Gs^Fms      , Gs^Fms      , Gs^Fms      , Gg          , Gs^Fms      , Gg          , Gg          , Ce          , Gg          , Re^Gvs      , Re^Gvs      , Rp          , Rp          , Rp          , Rp          , Rp          , Rp          , Rp          , Gg          , Gg          , Gs^Fms      , Ce          , Re^Gvs      , Hh          , Re^Gvs      , Gg          , Re^Gvs      , Gg          , Gs^Fms      , Gs^Fms      , Gs^Fms      , Gs^Fms      , Gg          , Gg          
Xv          , Gg          , Gs^Fms      , Gg          , Gg          , Gg          , Gg          , Gg          , Hh          , Gg          , Dd^Vdt      , Ce          , Ke          , Gg          , Gg          , Gg          , Rp          , Rp          , Rp          , Rp          , Rp          , Rp          , Rp          , Gg          , Gg          , Gs^Fms      , Ke          , Ce          , Gg          , Re^Gvs      , Dd^Vdt      , Dd^Vdt      , Gg          , Gs^Fms      , Gg          , Ce          , Ce          , Gs^Fms      , Gg          
Xv          , Gg          , Ce          , Ce          , Dd^Vdt      , Gg          , Ce          , Ce          , Ce          , Gg          , Gg^Dr       , Gg          , Rd          , Gg          , Hh          , Hh          , Ce          , Rp          , Ce          , Ce          , Ce          , Rp          , Ce          , Hh          , Hh          , Gg          , Gg^Dr       , Dd^Vdt      , Gs^Fms      , Gs^Fms      , Ce          , Ce          , Ce          , Gg          , Gg          , Ce          , Ke          , Ce          , Gg          
Xv          , Ce          , Ke          , Ce          , Hh          , Ce          , Ce          , 4 Ke        , Ce          , Ce          , Dd^Vdt      , Rd          , Gg          , Hh          , Gg^Dr       , Ce          , Ce          , Ce          , Ce          , 2 Ke        , Ce          , Ce          , Ce          , Ce          , Dd^Vdt      , Hh^Fds      , Gg          , Rd          , Rd          , Ce          , Ce          , 3 Ke        , Ce          , Ce          , Gg          , Ce          , Ce          , Ce          , Gg          
Xv          , Ce          , Ce          , Ce          , Hh          , Hh^Fds      , Hh          , Ce          , Rd          , Rd          , Rd          , Gg          , Ke          , Gg          , Gg          , Hh          , Rp          , Rp          , Rp          , Ce          , Rd          , Rp          , Rp          , Hh          , Gg          , Gg          , Ke          , Gg          , Gg          , Rd          , Gg          , Ce          , Gg          , Dd^Vdt      , Gg          , Ce          , Rd          , Dd^Vdt      , Gg          
Xv          , Gg          , Rd          , Ce          , Dd^Vdt      , Gg          , Gg^Dr       , Rd          , Rd          , Rd          , Ss          , Ce          , Ce          , Dd^Vdt      , Gg          , Gg          , Rp          , Rp          , Rd          , Rp          , Rd          , Rp          , Rp          , Gg          , Gg          , Gg          , Ce          , Ce          , Hh^Fds      , Rd          , Rd          , Rd          , Gs^Fms      , Gg^Dr       , Gs^Fms      , Gg          , Rd          , Gg          , Gg          
Xv          , Gg          , Gs^Fms      , Ss          , Ss          , Gg          , Rd          , Rd          , Re^Gvs      , Ss          , Ss          , Ss          , Rd          , Rd          , Gg          , Gg          , Rp          , Rp          , Rd          , Rp          , Rp          , Rp          , Rp          , Gg          , Gg          , Gg          , Rd          , Hh          , Gg          , Gg^Dr       , Gg          , Rd          , Rd          , Gs^Fms      , Gs^Fms      , Gg          , Rd          , Hh          , Gg          
Xv          , Gg          , Gs^Fds      , Rd          , Re^Gvs      , Re^Gvs      , Rd          , Re^Gvs      , Re^Gvs      , Re^Gvs      , Re^Gvs      , Rd          , Rd          , Rd          , Gg          , Hh          , Rp          , Rp          , Rd          , Rd          , Rd          , Rp          , Rp          , Hh^Fds      , Gg          , Gg          , Rd          , Rd          , Gs^Fms      , Gg          , Gs^Fds      , Re^Gvs      , Re^Gvs      , Rd          , Rd          , Gs^Fms      , Rd          , Hh          , Gg          
Xv          , Gs^Fms      , Gs^Fms      , Gs^Fds      , Rd          , Rd          , Re^Gvs      , Gs^Fds      , Re^Gvs      , Re^Gvs      , Gs^Fds      , Rd          , Re^Gvs      , Gg          , Gg          , Gs^Fds      , Hh          , Rp          , Wwf         , Rp          , Wwf         , Rp          , Ww          , Hh          , Gs^Fds      , Gg          , Rd          , Rd          , Gg          , Ss          , Ss          , Re^Gvs      , Ss          , Rd          , Rd          , Rd          , Gs^Fms      , Hh          , Gg          
Xv          , Gs^Fms      , Ss          , Ss          , Rd          , Rd          , Re^Gvs      , Re^Gvs      , Re^Gvs      , Re^Gvs      , Gs^Fds      , Gs^Fds      , Re^Gvs      , Re^Gvs      , Re^Gvs      , Hh          , Ww          , Ww^Bw|      , Ww          , Ww^Bw|      , Ww          , Ww^Bw|      , Ww          , Gs^Fds      , Gs^Fds      , Gg          , Rd          , Rd          , Gs^Fds      , Gs^Fms      , Ss          , Ss          , Ss          , Gg^Wm       , Rd          , Gs^Fms      , Gs^Fds      , Gg          , Gg          
Xv          , Re^Gvs      , Re^Gvs      , Gg^Wm       , Rd          , Rd          , Rd          , Gs^Fds      , Gs^Fds      , Gs^Fds      , Re^Gvs      , Re^Gvs      , Ww          , Re^Gvs      , Ww          , Ww          , Ww          , Ww^Bw|      , Wwf         , Ww^Bw|      , Wwf         , Ww^Bw|      , Ww          , Ww          , Wwf         , Ww          , Ww          , Gs^Fds      , Gs^Fms      , Ss          , Gg^Vh       , Gs^Fms      , Gs^Fds      , Re^Gvs      , Gs^Fds      , Gs^Fds      , Gs^Fms      , Re^Gvs      , Ww          
Xv          , Ww          , Ww          , Ww          , Ww^Bw/      , Rd          , Ww          , Gs^Fds      , Rd          , Gs^Fds      , Wwf         , Ww          , Gs^Fds      , Wwf         , Ww          , Ww          , Rp          , Rp          , Rp          , Rp          , Rd          , Rp          , Rp          , Ww          , Hh          , Ww          , Gs^Fds      , Gs^Fds      , Ww          , Rd          , Gs^Fds      , Gs^Fds      , Gs^Fds      , Rd          , Re^Gvs      , Rd          , Wwf         , Ww          , Gg          
Xv          , Gs^Fds      , Gs^Fds      , Gs^Fds      , Gs^Fds      , Ww          , Gg^Vh       , Ww          , Ww          , Ww          , Gs^Fds      , Gs^Fds      , Gg          , Gs^Fds      , Gg          , Gg          , Rp          , Rd          , Rp          , Rp          , Rp          , Rd          , Rp          , Gg          , Gg          , Hh          , Ss          , Gs^Fds      , Wwf         , Gs^Fds      , Rd          , Gs^Fds      , Re^Gvs      , Re^Gvs      , Wwf         , Wwf         , Re^Gvs      , Gg^Vh       , Gg          
Xv          , Gs^Fds      , Gs^Fms      , Gs^Fms      , Re^Gvs      , Ww          , Ww          , Gg^Wm       , Rd          , Gs^Fds      , Gs^Fds      , Gg          , Gg          , Gg          , Gg          , Dd^Vdt      , Rp          , Rd          , Rd          , Rp          , Rp          , Rp          , Rp          , Dd^Vdt      , Gg          , Gg          , Gg          , Ss          , Gs^Fds      , Ww          , Ww^Bw|      , Ww          , Ww          , Ww          , Re^Gvs      , Wwf         , Ww          , Gg          , Gg          
Xv          , Gs^Fds      , Re^Gvs      , Gs^Fds      , Re^Gvs      , Re^Gvs      , Gg          , Ww          , Rd          , Rd          , Gg          , Gg^Vh       , Gg          , Dd^Vdt      , Ce          , Ce          , Ce          , Rp          , Rp          , Rp          , Rp          , Rp          , Ce          , Ce          , Ce          , Dd^Vdt      , Gg          , Hh          , Wwf         , Wwf         , Gg          , Re^Gvs      , Re^Gvs      , Re^Gvs      , Gg^Wm       , Rd          , Gs^Fds      , Ww          , Ww          
Xv          , Ss          , Ss          , Re^Gvs      , Ss          , Gg          , Re^Gvs      , Ww          , Ww^Bw/      , Hh          , Gg          , Gg          , Gg          , Gg          , Ce          , 5 Ke        , Ce          , Rp          , Rp          , Rd          , Rp          , Rp          , Ce          , 1 Ke        , Ce          , Gg          , Gg          , Ww          , Rd          , Rd          , Gg          , Gg^Vh       , Gg          , Gg          , Rd          , Gs^Fds      , Gg^Vh       , Gs^Fds      , Gg          
Xv          , Ss          , Ss          , Ss          , Ss          , Ss          , Gg          , Gg^Vh       , Ww          , Hh          , Re^Gvs      , Re^Gvs      , Re^Gvs      , Dd^Vdt      , Gg          , Ce          , Rp          , Rp          , Rd          , Rd          , Rp          , Rp          , Rp          , Ce          , Gg          , Dd^Vdt      , Ww          , Wwf         , Rd          , Rd          , Re^Gvs      , Re^Gvs      , Re^Gvs      , Hh          , Hh          , Gs^Fds      , Gg          , Gg          , Gg          
Xv          , Gg          , Gg          , Gg          , Gg          , Ss          , Ww          , Ww          , Re^Gvs      , Re^Gvs      , Re^Gvs      , Re^Gvs      , Gg          , Gg          , Gg          , Rp          , Rp          , Rd          , Rp          , Rd          , Rd          , Rp          , Rp          , Rp          , Wwf         , Wwf         , Gg          , Gg          , Gg          , Rd          , Gg          , Re^Gvs      , Gg          , Gg          , Gg          , Gg          , Gg          , Gg          , Gg          
